code	name	country_code
aaa	anaa	pf
aab	arrabury	au
aac	el arish	eg
aae	annaba	dz
aaf	apalachicola	us
aag	arapoti	br
aah	aachen	de
aai	arraias	br
aaj	awaradam	sr
aak	aranuka	ki
aal	aalborg	dk
aam	mala mala	za
aan	al ain	ae
aao	anaco	ve
aaq	anapa	ru
aar	aarhus	dk
aas	apalapsili	id
aat	altay	cn
aau	asau	ws
aav	surallah	ph
aaw	abbottabad	pk
aax	araxa	br
aay	al ghaydah	ye
aaz	quetzaltenango	gt
aba	abakan	ru
abb	asaba	ng
abc	albacete	es
abd	abadan	ir
abe	allentown	us
abf	abaiang	ki
abg	abingdon	au
abh	alpha	au
abi	abilene	us
abj	abidjan	ci
abk	kabri dar	et
abl	ambler	us
abm	bamaga	au
abn	albina	sr
abo	aboisso	ci
abp	atkamba	pg
abq	albuquerque	us
abr	aberdeen	us
abs	abu simbel	eg
abt	al-baha	sa
abu	atambua	id
abv	abuja	ng
abw	abau	pg
abx	albury	au
aby	albany	us
abz	aberdeen	gb
aca	acapulco	mx
acb	bellaire	us
acc	accra	gh
acd	acandi	co
ace	arrecife	es
ach	altenrhein	ch
aci	alderney	gg
acj	anuradhapura	lk
ack	nantucket	us
acl	aguaclara	co
acm	arica	co
acn	acuna	mx
acp	sahand	ir
acr	araracuara	co
acs	achinsk	ru
act	waco	us
acu	achutupo	pa
acv	arcata	us
acx	xingyi	cn
acz	zabol	ir
ada	adana	tr
adc	andakombe	pg
add	addis ababa	et
ade	aden	ye
adf	adiyaman	tr
adg	adrian	us
adh	aldan	ru
adi	arandis	na
adk	adak island	us
adl	adelaide	au
adm	ardmore	us
adn	andes	co
ado	andamooka	au
adp	ampara	lk
adq	kodiak	us
adr	andrews	us
adt	ada	us
adu	ardabil	ir
adw	camp springs	us
adx	st andrews	gb
ady	alldays	za
adz	san andres island	co
aea	abemama atoll	ki
aeb	baise	cn
aed	aleneva	us
aee	adareil	ss
aeg	aek godang	id
aeh	abéché	td
aei	algeciras	es
aek	aseki	pg
ael	albert lea	us
aeo	aioun el atrouss	mr
aer	sochi	ru
aes	aalesund	no
aet	allakaket	us
aeu	abu musa	ir
aex	alexandria	us
aey	akureyri	is
afa	san rafael	ar
afd	port alfred	za
afi	amalfi	co
afl	alta floresta	br
afn	jaffrey	us
afo	afton	us
afr	afore	pg
afs	zarafshan	uz
aft	afutara	sb
afy	afyon	tr
afz	sabzevar	ir
aga	agadir	ma
agd	anggi	id
age	wangerooge	de
agf	agen	fr
agg	angoram	pg
agh	angelholm	se
agi	wageningen	sr
agj	aguni	jp
agk	kagua	pg
agl	wanigela	pg
agm	tasiilaq	gl
agn	angoon	us
ago	magnolia	us
agp	malaga	es
agq	agrinion	gr
agr	agra	in
ags	augusta	us
agt	ciudad del este	py
agu	aguascalientes	mx
agv	acarigua	ve
agw	agnew	au
agx	agatti island	in
agz	aggeneys	za
ahb	abha	sa
ahc	herlong	us
ahe	ahe	pf
ahf	arapahoe	us
ahh	amery	us
ahi	amahai	id
ahl	aishalton	gy
ahm	ashland	us
ahn	athens	us
aho	alghero	it
ahs	ahuas	hn
aht	amchitka	us
ahu	al hoceima	ma
ahw	saih rawl	om
ahy	ambatolahy	mg
ahz	alpe d huez	fr
aia	alliance	us
aib	anita bay	us
aic	airok	mh
aid	anderson	us
aie	aiome	pg
aif	assis	br
aig	yalinga	cf
aih	aiambak	pg
aii	alisabieh	dj
aik	aiken	us
ail	ailigandi	pa
aim	ailuk island	mh
ain	wainwright	us
aio	atlantic	us
aip	ailinglapalap island	mh
air	aripuana	br
ais	arorae island	ki
ait	aitutaki	ck
aiu	atiu island	ck
aiv	aliceville	us
aiw	ai-ais	na
aiy	atlantic city	us
aiz	kaiser	us
aja	ajaccio	fr
ajf	sakaka al jouf	sa
aji	agri	tr
ajj	akjoujt	mr
ajk	araak	ir
ajl	aizawl	in
ajn	anjouan	km
ajr	arvidsjaur	se
ajs	abreojos	mx
aju	aracaju	br
ajy	agades	ne
aka	ankang	cn
akb	atka	us
akd	akola	in
ake	akieni	ga
akf	kufrah	ly
akg	anguganak	pg
akh	al kharj	sa
aki	akiak	us
akj	asahikawa	jp
akk	akhiok	us
akl	auckland	nz
akm	zakouma	td
akn	king salmon	us
ako	akron	us
akp	anaktuvuk	us
akq	astraksetra	id
akr	akure	ng
aks	auki	sb
akt	akrotiri	cy
aku	aksu	cn
akv	akulivik	ca
akw	aghajari	ir
akx	aktyubinsk	kz
aky	sittwe	mm
ala	almaty	kz
alb	albany	us
alc	alicante	es
ald	alerta	pe
ale	alpine	us
alf	alta	no
alg	algiers	dz
alh	albany	au
ali	alice	us
alj	alexander bay	za
alk	asela	et
all	albenga	it
alm	alamogordo	us
aln	alton	us
alo	waterloo	us
alp	aleppo	sy
alq	alegrete	br
alr	alexandra	nz
als	alamosa	us
alt	alenquer	br
alu	alula	so
alw	walla walla	us
alx	alexander city	us
aly	alexandria	eg
alz	alitak	us
ama	amarillo	us
amb	ambilobe	mg
amc	am timan	td
amd	ahmedabad	in
ame	alto molocue	mz
amf	ama	pg
amg	amboin	pg
amh	arba mintch	et
ami	mataram	id
amj	almenara	br
aml	puerto armuellas	pa
amm	amman	jo
amn	alma	us
amo	mao	td
amp	ampanihy	mg
amq	ambon	id
amr	arno	mh
ams	amsterdam	nl
amt	amata	au
amu	amanab	pg
amv	amderma	ru
amw	ames	us
amx	ammaroo	au
amy	ambatomainty	mg
amz	ardmore	nz
ana	anaheim	us
anb	anniston	us
anc	anchorage	us
and	anderson	us
ane	angers	fr
anf	antofagasta	cl
ang	angouleme	fr
anh	anuha island resort	sb
ani	aniak	us
anj	zanaga	cg
ank	ankara	tr
anl	andulo	ao
anm	antalaha	mg
ann	annette island	us
ano	angoche	mz
anp	annapolis	us
anq	angola	us
anr	antwerp	be
ans	andahuaylas	pe
ant	st anton	at
anu	st. john's	ag
anv	anvik	us
anw	ainsworth	us
anx	andenes	no
any	anthony	us
anz	angus downs	au
aoa	aroa	pg
aob	annanberg	pg
aoc	altenburg	de
aod	abou deia	td
aog	anshan	cn
aoh	lima	us
aoi	ancona	it
aoj	aomori	jp
aok	karpathos	gr
aol	paso de los libres	ar
aom	adam	om
aon	arona	pg
aoo	martinsburg	us
aop	andoas	pe
aor	alor setar	my
aos	amook	us
aot	aosta	it
aou	attopeu	la
apb	apolo	bo
apc	napa	us
ape	san juan aposento	pe
apf	naples	us
apg	aberdeen	us
aph	bowling green	us
api	apiay	co
apk	apataki	pf
apl	nampula	mz
apn	alpena	us
apo	apartado	co
app	asapa	pg
apq	arapiraca	br
apr	april river	pg
aps	anapolis	br
apt	jasper	us
apu	apucarana	br
apv	apple valley	us
apw	apia	ws
apx	arapongas	br
apy	alto parnaiba	br
apz	zapala	ar
aqa	araraquara	br
aqb	quiche	gt
aqg	anqing	cn
aqi	qaisumah	sa
aqj	aqaba	jo
aqm	ariquemes	br
aqp	arequipa	pe
aqs	saqani	fj
aqy	alyeska	us
ara	new iberia	us
arb	ann arbor	us
arc	arctic village	us
ard	alor island	id
are	arecibo	pr
arf	acaricuara	co
arg	walnut ridge	us
arh	arkhangelsk	ru
ari	arica	cl
arj	arso	id
ark	arusha	tz
arl	arly	bf
arm	armidale	au
aro	arboletas	co
arp	aragip	pg
arq	arauquita	co
arr	alto rio senguerr	ar
ars	aragarcas	br
art	watertown	us
aru	aracatuba	br
arv	minocqua	us
arw	arad	ro
arx	neptune	us
ary	ararat	au
arz	n'zeto	ao
asa	assab	er
asb	ashgabat	tm
asc	ascension	bo
asd	andros town	bs
ase	aspen	us
asf	astrakhan	ru
asg	ashburton	nz
ash	nashua	us
asi	georgetown	sh
asj	amami	jp
ask	yamoussoukro	ci
asl	marshall	us
asm	asmara	er
asn	talladega	us
aso	asosa	et
asp	alice springs	au
asq	austin	us
asr	kayseri	tr
ast	astoria	us
asu	asuncion	py
asv	amboseli	ke
asw	aswan	eg
asx	ashland	us
asy	ashley	us
asz	asirim	pg
ata	anta	pe
atb	atbara	sd
atc	arthur's town	bs
atd	atoifi	sb
ate	antlers	us
atf	ambato	ec
atg	attock	pk
ath	athens	gr
ati	artigas	uy
atj	antsirabe	mg
atk	atqasuk	us
atl	atlanta	us
atm	altamira	br
atn	namatanai	pg
ato	athens	us
atp	aitape	pg
atq	amritsar	in
atr	atar	mr
ats	artesia	us
att	atmautluak	us
atu	attu island	us
atv	ati	td
atw	appleton	us
atx	atbasar	kz
aty	watertown	us
atz	assiut	eg
aua	aruba	aw
aub	itauba	br
auc	arauca	co
aud	augustus downs	au
aue	abu rudeis	eg
auf	auxerre	fr
aug	augusta	us
auh	abu dhabi	ae
aui	aua island	pg
auj	ambunti	pg
auk	alakanuk	us
aul	aur island	mh
aum	austin	us
aun	auburn	us
auo	auburn	us
aup	agaun	pg
auq	atuona	pf
aur	aurillac	fr
aus	austin	us
aut	atauro	id
auu	aurukun mission	au
auv	aumo	pg
auw	wausau	us
aux	araguaina	br
auy	aneityum	vu
auz	aurora	us
ava	an shun	cn
avb	aviano	it
avg	auvergne	au
avi	ciego de avila	cu
avk	arvaikheer	mn
avl	fletcher	us
avn	avignon	fr
avo	avon park	us
avp	wilkes-barre	us
avu	avu avu	sb
avx	avalon	us
awa	awassa	et
awb	awaba	pg
awd	aniwa	vu
awe	alowe	ga
awk	wake island	um
awm	west memphis	us
awn	alton downs	au
awp	austral downs	au
awr	awar	pg
awz	ahwaz	ir
axa	anguilla	ai
axb	alexandria bay	us
axc	aramac	au
axd	alexandroupolis	gr
axe	xanxere	br
axg	algona	us
axk	ataq	ye
axl	alexandria	au
axm	armenia	co
axn	alexandria	us
axp	spring point	bs
axr	arutua	pf
axt	akita	jp
axu	axum	et
axv	wapakoneta	us
axx	angel fire	us
aya	ayapel	co
ayc	ayacucho	co
ayd	alroy downs	au
aye	fort devens	us
ayg	yaguara	co
ayi	yari	co
ayk	arkalyk	kz
ayl	anthony lagoon	au
ayn	anyang	cn
ayo	ayolas	py
ayp	ayacucho	pe
ayq	ayers rock	au
ayr	ayr	au
ays	waycross	us
ayt	antalya	tr
ayu	aiyura	pg
ayw	ayawasi	id
ayy	pothuvil	lk
ayz	amityville	us
azb	amazon bay	pg
azd	yazd	ir
azg	apatzingan	mx
azl	sapezal	br
azn	andizhan	uz
azo	kalamazoo	us
azr	adrar	dz
azs	el catey	do
azt	zapatoca	co
azz	ambriz	ao
baa	bialla	pg
bac	barranca de upia	co
bae	barcelonnette	fr
baf	westfield	us
bag	baguio	ph
bah	manama	bh
bai	buenos aires	cr
baj	bali	pg
bak	baku	az
bal	batman	tr
bam	battle mountain	us
ban	basongo	cd
bao	ban mak khaen	th
bap	baibara	pg
baq	barranquilla	co
bar	baker island	us
bas	balalae	sb
bat	barretos	br
bav	baotou	cn
baw	biawonque	ga
bax	barnaul	ru
bay	baia mare	ro
baz	barbelos	br
bba	balmaceda	cl
bbb	benson	us
bbc	bay city	us
bbd	brady	us
bbf	burlington	us
bbg	butaritari	ki
bbh	barth	de
bbi	bhubaneswar	in
bbj	bitburg	de
bbk	kasane	bw
bbm	battambang	kh
bbn	bario	my
bbo	berbera	so
bbp	bembridge	gb
bbq	barbuda	ag
bbr	basse terre	gp
bbs	yateley	gb
bbt	berberati	cf
bbv	bereby	ci
bbw	broken bow	us
bbx	blue bell	us
bby	bambari	cf
bbz	zambezi	zm
bca	baracoa	cu
bcb	blacksburg	us
bcc	bear creek	us
bcd	bacolod	ph
bce	bryce	us
bcf	bouca	cf
bcg	bemichi	gy
bch	baucau	tl
bci	barcaldine	au
bcj	baca grande	us
bck	bolwarra	au
bcl	barra colorado	cr
bcm	bacau	ro
bcn	barcelona	es
bco	jinka	et
bcp	bambu	pg
bcq	brack	ly
bcr	boca do acre	br
bcs	belle chasse	us
bct	boca raton	us
bcu	bauchi	ng
bcv	belmopan	bz
bcw	benguera island	mz
bcx	beloreck	ru
bcy	bulchi	et
bcz	bickerton island	au
bda	st. george	bm
bdb	bundaberg	au
bdc	barra do corda	br
bdd	badu island	au
bde	baudette	us
bdf	bradford	us
bdg	blanding	us
bdh	bandar lengeh	ir
bdi	bird island	sc
bdj	banjarmasin	id
bdk	bondoukou	ci
bdl	windsor locks	us
bdm	bandirma	tr
bdn	badin	pk
bdo	bandung	id
bdp	bhadrapur	np
bdq	vadodara	in
bdr	bridgeport	us
bds	brindisi	it
bdt	gbadolite	cd
bdu	bardufoss	no
bdv	moba	cd
bdw	bedford downs	au
bdx	broadus	us
bdy	bandon	us
bdz	baindoung	pg
bea	bereina	pg
beb	benbecula	gb
bed	bedford	us
bee	beagle bay	au
bef	bluefields	ni
beg	belgrade	rs
beh	benton harbor	us
bei	beica	et
bej	tanjung redep	id
bek	bareli	in
bel	belem	br
ben	benghazi	ly
bep	bellary	in
beq	bury st edmunds	gb
ber	berlin	de
bes	brest	fr
bet	bethel	us
beu	bedourie	au
bev	beer sheba	il
bew	beira	mz
bex	benson	gb
bey	beirut	lb
bez	beru	ki
bfa	bahia negra	py
bfb	blue fox bay	us
bfc	bloomfield	au
bfd	bradford	us
bfe	bielefeld	de
bff	scottsbluff	us
bfg	bullfrog basin	us
bfh	curitiba.	br
bfl	bakersfield	us
bfn	bloemfontein	za
bfo	buffalo range	zw
bfp	beaver falls	us
bfq	bahia pinas	pa
bfr	bedford	us
bfs	belfast	gb
bft	beaufort	us
bfu	bengbu	cn
bfv	buri ram	th
bfw	sidi belabbes	dz
bfx	bafoussam	cm
bga	bucaramanga	co
bgb	booue	ga
bgc	braganca	pt
bgd	borger	us
bge	bainbridge	us
bgf	bangui	cf
bgg	bongouanou	tr
bgh	boghe	mr
bgi	bridgetown	bb
bgj	borgarfjordur eystri	is
bgk	big creek	bz
bgl	baglung	np
bgm	binghamton	us
bgo	bergen	no
bgp	bongo	ga
bgq	big lake	us
bgr	bangor	us
bgt	bagdad	us
bgu	bangassou	cf
bgv	bento goncalves	br
bgw	baghdad	iq
bgx	bage	br
bgz	braga	pt
bha	bahia de caraquez	ec
bhb	bar harbor	us
bhc	bhurban	pk
bhe	blenheim	nz
bhf	bahia cupica	co
bhg	brus laguna	hn
bhh	bisha	sa
bhi	bahia blanca	ar
bhj	bhuj	in
bhk	bukhara	uz
bhl	bahia angeles	mx
bhm	birmingham	us
bhn	beihan	ye
bho	bhopal	in
bhp	bhojpur	np
bhq	broken hill	au
bhr	bharatpur	np
bhs	bathurst	au
bht	brighton downs	au
bhu	bhavnagar	in
bhv	bahawalpur	pk
bhx	birmingham	gb
bhy	beihai	cn
bhz	belo horizonte	br
bia	bastia	fr
bib	baidoa	so
bic	big creek	us
bid	block island	us
bie	beatrice	us
big	big delta	us
bih	bishop	us
bii	bikini atoll	mh
bij	biliau	pg
bik	biak	id
bil	billings	us
bim	bimini	bs
bin	bamiyan	af
bio	bilbao	es
bip	bulimba	au
biq	biarritz	fr
bir	biratnagar	np
bis	bismarck	us
bit	baitadi	np
biu	bildudalur	is
biv	bria	cf
biw	billiluna	au
bix	biloxi	us
biy	bisho	za
biz	bimin	pg
bja	bejaia	dz
bjb	bojnord	ir
bjc	broomfield	us
bjd	bakkafjordur	is
bje	baleela	sd
bjf	batsfjord	no
bjg	bolaang	id
bjh	bajhang	np
bji	bemidji	us
bjj	wooster	us
bjk	benjina	id
bjl	banjul	gm
bjm	bujumbura	bi
bjn	bajone	mz
bjo	bermejo	bo
bjp	braganca paulista	br
bjq	bahja	om
bjr	bahar dar	et
bjs	beijing	cn
bjt	bentota river	lk
bju	bajura	np
bjv	milas	tr
bjw	bajawa	id
bjx	león	mx
bjz	badajoz	es
bkb	bikaner	in
bkc	buckland	us
bkd	breckenridge	us
bke	baker	us
bkf	katmai national park	us
bkg	branson	us
bkh	kekaha	us
bki	kota-kinabalu	my
bkj	boke	gn
bkk	bangkok	th
bkm	bakalalan	my
bko	bamako	ml
bkp	barkly downs	au
bkq	blackall	au
bkr	bokoro	td
bks	bengkulu	id
bkt	blackstone	us
bku	betioky	mg
bkw	beckley	us
bkx	brookings	us
bky	bukavu	cd
bkz	bukoba	tz
bla	barcelona	ve
blb	balboa	pa
blc	bali	cm
ble	borlange	se
blf	princeton	us
blg	belaga	my
blh	blythe	us
bli	bellingham	us
blj	batna	dz
blk	blackpool	gb
bll	billund	dk
blm	belmar - farmingdale	us
bln	benalla	au
blo	blonduos	is
blp	bellavista	pe
blq	bologna	it
blr	bangalore	in
bls	bollon	au
blt	blackwater	au
blu	blue canyon	us
blv	belleville	us
blw	waimanalo	us
blx	belluno	it
bly	belmullet	ie
blz	blantyre	mw
bmb	bumba	cd
bmc	brigham city	us
bmd	belo	mg
bme	broome	au
bmf	bakouma	cf
bmg	bloomington	us
bmh	bomai	pg
bmi	bloomington	us
bmj	baramita	gy
bmk	borkum	de
bml	berlin	us
bmm	bitam	ga
bmn	bamerny	iq
bmo	bhamo	mm
bmp	brampton island	au
bmq	bamburi	ke
bmr	baltrum island	de
bms	brumado	br
bmu	bima	id
bmv	banmethuot	vn
bmw	bordj badji mokhtar	dz
bmx	big mountain	us
bmy	belep island	nc
bmz	bamu	pg
bna	nashville	us
bnb	boende	cd
bnc	beni	cd
bnd	bandar abbas	ir
bne	brisbane	au
bnf	baranof	us
bng	banning	us
bni	benin city	ng
bnk	ballina	au
bnl	barnwell	us
bnm	bodinumu	pg
bnn	bronnoysund	no
bno	burns	us
bnp	bannu	pk
bnq	baganga	ph
bnr	banfora	bf
bns	barinas	ve
bnt	bundi	pg
bnu	blumenau	br
bnv	boana	pg
bnw	boone	us
bnx	banja luka	ba
bny	bellona	sb
bnz	banz	pg
boa	boma	cd
bob	bora bora	pf
boc	bocas del toro	pa
bod	bordeaux	fr
boe	boundji	cg
bog	bogota	co
boh	bournemouth	gb
boi	boise	us
boj	bourgas	bg
bok	brookings	us
bol	ballykelly	gb
bom	mumbai	in
bon	kralendijk	bq
boo	bodo	no
bop	bouar	cf
boq	boku	pg
bos	boston	us
bot	boset	pg
bou	bourges	fr
bov	boang	pg
bow	bartow	us
box	borroloola	au
boy	bobo dioulasso	bf
boz	bozoum	cf
bpa	bethpage	us
bpb	boridi	pg
bpc	bamenda	cm
bpd	bapi	pg
bpe	bagan	mm
bpf	batuna	sb
bpg	barra do garcas	br
bph	bislig	ph
bpi	big piney	us
bpk	biangabip	pg
bpl	bole	cn
bpn	balikpapan	id
bpo	bo'ao	cn
bps	porto seguro	br
bpt	beaumont	us
bpu	beppu	jp
bpx	bangda	cn
bpy	besalampy	mg
bqa	baler	ph
bqb	bussellton	au
bqe	bubaque	gw
bqg	bogorodskoye	ru
bqi	bagani	na
bqj	batagay	ru
bql	boulia	au
bqn	aguadilla	pr
bqo	bouna	ci
bqq	barra	br
bqs	blagoveschensk	ru
bqt	brest	by
bqu	bequia	vc
bqw	balgo hills	au
bra	barreiras	br
brb	barreirinhas	br
brc	san carlos debariloche	ar
brd	brainerd	us
bre	bremen	de
brg	whitesburg	us
brh	brahman	pg
bri	bari	it
brj	bright	au
brk	bourke	au
brl	burlington	us
brm	barquisimeto	ve
brn	berne	ch
bro	brownsville	us
brp	biaru	pg
brq	brno	cz
brr	barra	gb
brs	bristol	gb
brt	bathurst island	au
bru	brussels	be
brv	bremerhaven	de
brw	barrow	us
brx	barahona	do
bry	bardstown	us
brz	borotou	it
bsa	bossaso	so
bsb	brasilia	br
bsc	bahia solano	co
bsd	baoshan	cn
bse	sematan	my
bsf	pohakuloa	us
bsg	bata	gq
bsh	brighton	gb
bsi	blairsville	us
bsj	bairnsdale	au
bsk	biskra	dz
bsm	bishe-kola	ir
bsn	bossangoa	cf
bso	basco	ph
bsp	bensbach	pg
bsq	bisbee	us
bsr	basra	iq
bss	balsas	br
bst	bost	af
bsu	basankusu	cd
bsv	besakoa	mg
bsw	boswell bay	us
bsx	bassein	mm
bsy	bardera	so
bsz	bartletts	us
bta	yaoundé	cm
btb	betou	cg
btc	batticaloa	lk
btd	brunette downs	au
bte	bonthe	sl
btf	bountiful	us
btg	batangafo	cf
bth	batam	id
bti	barter island	us
btj	banda aceh	id
btk	bratsk	ru
btl	battle creek	us
btm	butte	us
btn	bennettsville	us
bto	botopasie	sr
btp	butler	us
btq	butare	rw
btr	baton rouge	us
bts	bratislava	sk
btt	bettles	us
btu	bintulu	my
btv	burlington	us
btw	batu licin	id
btx	betoota	au
bty	beatty	us
bua	buka	pg
bub	burwell	us
buc	burketown	au
bud	budapest	hu
bue	buenos aires	ar
buf	buffalo	us
bug	benguela	ao
buh	bucharest	ro
bui	bokondini	id
buj	boussaada	dz
buk	albuq	ye
bul	bulolo	pg
bum	butler	us
bun	buenaventura	co
buo	burao	so
bup	bhatinda	in
buq	bulawayo	zw
bur	burbank	us
bus	batumi	ge
buv	bella union	uy
buw	baubau	id
bux	bunia	cd
buy	bunbury	au
buz	bushehr	ir
bvb	boa vista	br
bvc	boa vista	cv
bvd	beaver inlet	us
bve	brive-la-gaillarde	fr
bvf	bua	fj
bvg	berlevag	no
bvh	vilhena	br
bvi	birdsville	au
bvk	huacaraje	bo
bvl	baures	bo
bvm	belmonte	br
bvo	bartlesville	us
bvp	bolovip	pg
bvr	brava	cv
bvs	breves	br
bvu	beluga	us
bvv	iturup island	ru
bvw	batavia downs	au
bvx	batesville	us
bvy	beverly	us
bvz	beverley springs	au
bwa	bhairawa	np
bwb	barrow island	au
bwc	brawley	us
bwd	brownwood	us
bwe	braunschweig	de
bwf	barrow-in-furness	gb
bwg	bowling green	us
bwh	butterworth	my
bwi	baltimore	us
bwj	bawan	pg
bwk	bol	hr
bwl	blackwell	us
bwm	bowman	us
bwn	bandar seri begawan	bn
bwo	balakovo	ru
bwp	bewani	pg
bwq	brewarrina	au
bws	blaine	us
bwt	burnie	au
bww	cayo las brujas	cu
bxa	bogalusa	us
bxb	babo	id
bxc	boxborough	us
bxd	bade	id
bxe	bakel	sn
bxf	belburn	au
bxg	bendigo	au
bxh	balhash	kz
bxi	boundiali	ci
bxk	buckeye	us
bxl	blue lagoon	fj
bxm	batom	id
bxo	buochs	ch
bxp	biala podlaska	pl
bxr	bam	ir
bxs	borrego springs	us
bxt	bontang	id
bxu	butuan	ph
bxv	breiddalsvik	is
bxx	borama	so
bxz	bunsil	pg
bya	boundary	us
byb	dibaa	om
byc	yacuiba	bo
byd	beidah	ye
byf	albert	fr
byg	buffalo	us
byh	blytheville	us
byi	rupert	us
byj	beja	pt
byk	bouake	ci
byl	bella yella	lr
bym	bayamo	cu
byn	bayankhongor	mn
byo	bonito	br
byq	bunyu	id
byr	laeso island	dk
bys	fort irwin	us
byt	bantry	ie
byu	bayreuth	de
byw	blakely island	us
byx	baniyala	au
bza	bonanza	ni
bzb	bazaruto island	mz
bzc	buzios	br
bzd	balranald	au
bze	belize city	bz
bzg	bydgoszcz	pl
bzh	bumi hills	zw
bzi	balikesir	tr
bzk	briansk	ru
bzl	barisal	bd
bzm	bergen op zoom	mg
bzn	bozeman	us
bzo	bolzano	it
bzp	bizant	au
bzr	beziers	fr
bzt	brazoria	us
bzu	buta	cd
bzv	brazzaville	cg
bzy	beltsy	md
bzz	brize norton	gb
caa	catacamas	hn
cab	cabinda	ao
cac	cascavel	br
cad	cadillac	us
cae	columbia	us
caf	carauari	br
cag	cagliari	it
cah	ca mau	vn
cai	cairo	eg
caj	canaima	ve
cak	akron/canton	us
cal	campbeltown	gb
cam	camiri	bo
can	guangzhou	cn
cao	clayton	us
cap	cap haitien	ht
caq	caucasia	co
car	caribou	us
cas	casablanca	ma
cat	cat island	bs
cau	caruaru	br
cav	cazombo	ao
caw	campos	br
cax	carlisle	gb
cay	cayenne	gf
caz	cobar	au
cba	corner bay	us
cbb	cochabamba	bo
cbc	cherrabun	au
cbd	car nicobar	in
cbe	cumberland	us
cbf	council bluffs	us
cbg	cambridge	gb
cbh	béchar	dz
cbi	cape barren island	au
cbj	cabo rojo	do
cbk	colby	us
cbl	ciudad bolivar	ve
cbn	cirebon	id
cbo	cotabato	ph
cbp	coimbra	pt
cbq	calabar	ng
cbr	canberra	au
cbs	cabimas	ve
cbt	catumbela	ao
cbu	cottbus	de
cbv	coban	gt
cbw	campo mourao	br
cbx	condobolin	au
cby	canobie	au
cbz	cabin creek	us
cca	fort chaffee	us
ccb	upland	us
ccc	cayo coco	cu
ccf	carcassonne	fr
ccg	crane	us
cch	chile chico	cl
cci	concordia	br
ccj	kozhikode	in
cck	cocos islands	cc
ccl	chinchilla	au
ccm	criciuma	br
ccn	chakcharan	af
cco	carimagua	co
ccp	concepcion	cl
ccq	cachoeira	br
ccr	concord	us
ccs	caracas	ve
cct	colonia catriel	ar
ccu	kolkata	in
ccv	craig cove	vu
ccw	cowell	au
ccx	caceres	br
ccy	charles city	us
ccz	chub cay	bs
cda	cooinda	au
cdb	cold bay	us
cdc	cedar city	us
cdd	cauquira	hn
cde	caledonia	pa
cdh	camden	us
cdi	cachoeiro itapemirim	br
cdj	conceicao do araguaia	br
cdk	cedar key	us
cdl	candle	us
cdn	camden	us
cdo	cradock	za
cdp	cuddapah	in
cdq	croydon	au
cdr	chadron	us
cds	childress	us
cdt	castellon de la plana	es
cdu	camden	au
cdv	cordova	us
cdw	caldwell	us
cdy	cagayan de sulu	ph
cdz	cadiz	es
ceb	cebu	ph
cec	crescent city	us
ced	ceduna	au
cee	cherepovets	ru
cef	chicopee	us
ceg	chester	gb
ceh	chelinda	mw
cei	chiang rai	th
cek	chelyabinsk	ru
cel	cape eleuthera	bs
cem	central	us
cen	ciudad obregon	mx
ceo	waco kungo	ao
cep	concepcion	bo
ceq	cannes	fr
cer	cherbourg	fr
ces	cessnock	au
cet	cholet	fr
ceu	clemson	us
cev	connersville	us
cew	crestview	us
cex	chena hot springs	us
cey	murray	us
cez	cortez	us
cfa	coffee point	us
cfb	cabo frio	br
cfc	cacador	br
cfd	bryan	us
cfe	clermont-ferrand	fr
cff	cafunfo	ao
cfg	cienfuegos	cu
cfh	clifton hills	au
cfi	camfield	au
cfk	chlef	dz
cfn	carrickfinn	ie
cfo	confreza	br
cfp	carpentaria downs	au
cfq	creston	ca
cfr	caen	fr
cfs	coffs harbour	au
cft	clifton	us
cfu	kerkyra	gr
cfv	coffeyville	us
cga	craig	us
cgb	cuiaba	br
cgc	cape gloucester	pg
cgd	changde	cn
cge	cambridge	us
cgg	casiguran	ph
cgi	cape girardeau	us
cgj	chingola	zm
cgm	camiguin	ph
cgn	cologne	de
cgo	zhengzhou	cn
cgp	chittagong	bd
cgq	changchun	cn
cgr	campo grande	br
cgs	college park	us
cgt	chinguitti	mr
cgu	ciudad guayana	ve
cgv	caiguna	au
cgy	cagayan de oro	ph
cgz	casa grande	us
cha	chattanooga	us
chb	chilas	pk
chc	christchurch	nz
chf	jinhae	kr
chg	chaoyang	cn
chh	chachapoyas	pe
ord	chicago	us
chj	chipinge	zw
chk	chickasha	us
chl	challis	us
chm	chimbote	pe
chn	jeonju	kr
cho	charlottesville	us
chp	circle hot springs	us
chq	chania	gr
chr	chateauroux	fr
chs	charleston	us
cht	chatham island	nz
chu	chuathbaluk	us
chv	chaves	pt
chw	jiuquan	cn
chx	changuinola	pa
chy	choiseul bay	sb
chz	chiloquin	us
cic	chico	us
cid	cedar rapids	us
cie	collie	au
cif	chifeng	cn
cig	craig	us
cih	changzhi	cn
cii	aydin	tr
cij	cobija	bo
cik	chalkyitsik	us
cil	council	us
cim	cimitarra	co
cin	carroll	us
cio	concepcion	py
cip	chipata	zm
ciq	chiquimula	gt
cir	cairo	us
cis	canton island	ki
cit	shimkent	kz
civ	chomley	us
ciw	canouan island	vc
cix	chiclayo	pe
ciy	comiso	it
ciz	coari	br
cja	cajamarca	pe
cjb	coimbatore	in
cjc	calama	cl
cjd	candilejas	co
cjh	chilko lake	ca
cjj	cheongju	kr
cjl	chitral	pk
cjm	chumphon	th
cjn	el cajon	us
cjs	ciudad juarez	mx
cjt	comitan	mx
cju	jeju	kr
cka	cherokee	us
ckb	clarksburg	us
ckc	cherkassy	ua
ckd	crooked creek	us
cke	clear lake	us
ckg	chongqing	cn
ckh	chokurdah	ru
cki	croker island	au
ckk	cherokee	us
ckl	chkalovsky	ru
ckm	clarksdale	us
ckn	crookston	us
cko	cornelio procopio	br
ckr	crane island	us
cks	carajas	br
ckt	sarakhs	ir
ckv	clarksville	us
ckw	christmas creek mine	au
ckx	chicken	us
cky	conakry	gn
ckz	canakkale	tr
cla	comilla	bd
clc	clearlake	us
cle	cleveland	us
clg	coalinga	us
clh	coolah	au
cli	clintonville	us
clj	cluj-napoca	ro
cll	college station	us
clm	port angeles	us
cln	carolina	br
clo	cali	co
clp	clarks point	us
clq	colima	mx
clr	calipatria	us
cls	chehalis	us
clt	charlotte	us
clu	columbus	us
clv	caldas novas	br
clw	clearwater	us
clx	clorinda	ar
cly	calvi	fr
clz	calabozo	ve
cma	cunnamulla	au
cmb	colombo	lk
cmc	camocim	br
cmd	cootamundra	au
cme	ciudad del carmen	mx
cmf	chambery	fr
cmg	corumba	br
cmh	columbus	us
cmi	champaign	us
cmj	chi mei	tw
cmk	club makokola	mw
cml	camooweal	au
cmm	carmelita	gt
cmo	obbia	so
cmp	santana do araguaia	br
cmq	clermont	au
cmr	colmar	fr
cms	scusciuban	so
cmt	cameta	br
cmu	kundiawa	pg
cmv	coromandel	nz
cmw	camaguey	cu
cmx	hancock	us
cmy	sparta	us
cmz	caia	mz
cna	cananea	mx
cnb	coonamble	au
cnc	coconut island	au
cnd	constanta	ro
cne	canon city	us
cng	cognac	fr
cnh	claremont	us
cni	changhai	cn
cnj	cloncurry	au
cnk	concordia	us
cnl	sindal	dk
cnm	carlsbad	us
cno	chino	us
cnp	neerlerit inaat	gl
cnq	corrientes	ar
cnr	chanaral	cl
cns	cairns	au
cnt	charata	ar
cnu	chanute	us
cnv	canavieiras	br
cnx	chiang mai	th
cny	moab	us
cnz	cangamba	ao
coa	columbia	us
cob	coolibah	au
coc	concordia	ar
cod	cody	us
coe	coeur d'alene	us
cog	condoto	co
coh	cooch behar	in
coi	cocoa	us
coj	coonabarabran	au
cok	kochi	in
col	isle of coll	gb
com	coleman	us
con	concord	us
coo	cotonou	bj
cop	cooperstown	us
coq	choibalsan	mn
cor	cordoba	ar
cos	colorado springs	us
cot	cotulla	us
cou	columbia	us
cov	covilha	pt
cow	coquimbo	cl
cox	congo town	bs
coy	coolawanyah	au
coz	constanza	do
cpa	cape palmas	lr
cpb	capurgana	co
cpc	san martin delos andes	ar
cpd	coober pedy	au
cpe	campeche	mx
cpf	cepu	id
cpg	carmen de patagones	ar
cph	copenhagen	dk
cpi	cape orford	pg
cpl	chaparral	co
cpm	compton	us
cpn	cape rodney	pg
cpo	copiapo	cl
cpq	campinas	br
cpr	casper	us
cpt	cape town	za
cpu	cururupu	br
cpv	campina grande	br
cpx	culebra	pr
cqa	canarana	br
cqd	shahre-kord	ir
cqf	calais	fr
cqm	ciudad real	es
cqp	cape flattery	au
cqs	costa marques	br
cqt	caquetania	co
cra	craiova	ro
crb	collarenebri	au
crc	cartago	co
crd	comodoro rivadavia	ar
crf	carnot	cf
crh	cherribah	au
cri	crooked island	bs
crj	coorabie	au
crm	catarman	ph
cro	corcoran	us
crp	corpus christi	us
crq	caravelas	br
crr	ceres	ar
crs	corsicana	us
crt	crossett	us
cru	carriacou island	gd
crv	crotone	it
crw	charleston	us
crx	corinth	us
cry	carlton hill	au
crz	turkmenabad	tm
csa	isle of colonsay	gb
csb	caransebes	ro
csc	canas	cr
csd	cresswell downs	au
cse	crested butte	us
csf	creil	fr
csg	columbus	us
csh	solovetsky	ru
csi	casino	au
csj	cape st jacques	vn
csk	cap skirring	sn
csl	san luis obispo	us
csm	clinton	us
csn	carson city	us
cso	cochstedt	de
csp	cape spencer	us
csq	creston	us
csr	casuarito	co
css	cassilandia	br
cst	castaway	fj
csu	santa cruz do sul	br
csv	crossville	us
csw	colorado do oeste	br
csx	changsha	cn
csy	cheboksary	ru
csz	coronel suarez	ar
cta	catania	it
ctb	cut bank	us
ctc	catamarca	ar
ctd	chitre	pa
cte	carti	pa
ctf	coatepeque	gt
ctg	cartagena	co
cth	coatesville	us
cti	cuito cuanavale	ao
ctj	carrollton	it
ctk	canton	us
ctl	charleville	au
ctm	chetumal	mx
ctn	cooktown	au
cto	calverton	us
ctp	carutapera	br
ctq	santa vitoria	br
ctr	cattle creek	au
ctt	le castellet	fr
ctu	chengdu	cn
ctw	cottonwood	us
ctx	cortland	us
cty	cross city	us
ctz	clinton	us
cua	ciudad constitucion	mx
cuc	cucuta	co
cud	caloundra	au
cue	cuenca	ec
cuf	cuneo	it
cug	cudal	au
cuh	cushing	us
cui	currillo	co
cuj	culion	ph
cuk	caye caulker	bz
cul	culiacan	mx
cum	cumana	ve
cun	cancun	mx
cuo	caruru	co
cup	carupano	ve
cuq	coen	au
cur	curacao	cw
cus	columbus	us
cut	cutral	ar
cuu	chihuahua	mx
cuv	casigua	ve
cuw	cube cove	us
cuy	cue	au
cuz	cuzco	pe
cvb	chungribu	pg
cvc	cleve	au
cve	covenas	co
cvf	courchevel	fr
cvg	covington	us
cvh	caviahue	ar
cvi	caleta olivia	ar
cvj	cuernavaca	mx
cvl	cape vogel	pg
cvm	ciudad victoria	mx
cvn	clovis	us
cvo	albany	us
cvq	carnarvon	au
cvr	culver city	us
cvt	coventry	gb
cvu	corvo island	pt
cwb	curitiba	br
cwc	chernovtsy	ua
cwg	callaway gardens	us
cwi	clinton	us
cwl	cardiff	gb
cwp	campbellpore	pk
cwr	cowarie	au
cws	center island	us
cwt	cowra	au
cww	corowa	au
cwx	willcox	us
cxa	caicara del orinoco	ve
cxb	cox's bazar	bd
cxc	chitina	us
cxf	coldfoot	us
cxi	christmas island	ki
cxj	caxias do sul	br
cxl	calexico	us
cxn	candala	so
cxo	conroe	us
cxp	cilacap	id
cxq	christmas creek	au
cxt	charters towers	au
cxy	cat cays	bs
cya	les cayes	ht
cyb	cayman brac island	ky
cyc	caye chapel	bz
cye	crystal lake	us
cyf	chefornak	us
cyg	corryong	au
cyi	chiayi	tw
cyl	coyoles	hn
cym	chatham	us
cyo	cayo largo del sur	cu
cyp	calbayog	ph
cyr	colonia	uy
cys	cheyenne	us
cyt	yakataga	us
cyu	cuyo	ph
cyw	celaya	mx
cyx	cherskiy	ru
cyz	cauayan	ph
cza	chichen itza	mx
czb	cruz alta	br
czc	copper centre	us
cze	coro	ve
czf	cape romanzof	us
czh	corozal	bz
czj	corazon de jesus	pa
czk	cascade locks	us
czl	constantine	dz
czm	cozumel	mx
czn	chisana	us
czo	chistochina	us
czp	cape pole	us
czs	cruzeiro do sul	br
czt	carrizo springs	us
czu	corozal	co
czw	czestochowa	pl
czx	changzhou	cn
czy	cluny	au
czz	campo	us
daa	fort belvoir	us
dab	daytona beach	us
dac	dhaka	bd
dad	da nang	vn
daf	daup	pg
dag	daggett	us
dah	dathina	ye
daj	dauan island	au
dak	dakhla oasis	eg
dam	damascus	sy
dan	danville	us
dao	dabo	pg
dap	gokuleshwar	np
dar	dar es salaam	tz
das	great bear lake	ca
dat	datong	cn
dau	daru	pg
dav	david	pa
dax	daxian	cn
day	dayton	us
daz	darwaz	af
dba	dalbandin	pk
dbb	dabaa city	eg
dbd	dhanbad	in
dbm	debra marcos	et
dbn	dublin	us
dbo	dubbo	au
dbp	debepare	pg
dbq	dubuque	us
dbs	dubois	us
dbt	debra tabor	et
dbu	dambula	lk
dbv	dubrovnik	hr
dby	dalby	au
dci	decimomannu	it
dck	dahl creek	us
dcm	castres	fr
dcp	cabin plant	ca
dcr	decatur	us
dct	duncan town	bs
dcu	decatur	us
dcy	daocheng	cn
ddc	dodge city	us
ddg	dandong	cn
ddi	daydream island	au
ddm	dodoima	pg
ddn	delta downs	au
ddp	dorado	pr
ddu	dadu	pk
dea	dera ghazi khan	pk
deb	debrecen	hu
dec	decatur	us
ded	dehra dun	in
dee	yuzhno-kurilsk	ru
def	dezful	ir
deh	decorah	us
dei	denis island	sc
del	new delhi	in
dem	dembidollo	et
den	denver	us
deo	dearborn	us
dep	deparizo	in
der	derim	pg
des	desroches	sc
dey	deyang	cn
dez	deirezzor	sy
dfi	defiance	us
dfp	drumduff	au
dfw	dallas	us
dga	dangriga	bz
dgb	danger bay	us
dgc	degahbur	et
dgd	dalgaranga	au
dge	mudgee	au
dgf	douglas lake	ca
dgg	daugo	pg
dgk	dugong	mz
dgm	dongguan	lk
dgn	dahlgren	us
dgo	durango	mx
dgp	daugavpils	lv
dgr	dargaville	nz
dgt	dumaguete	ph
dgu	dedougou	bf
dgw	douglas	us
dha	dhahran	sa
dhb	deer harbor	us
dhd	durham downs	au
dhi	dhangarhi	np
dhl	dhala	ye
dhm	dharamsala	in
dhn	dothan	us
dho	horn river	ca
dhr	den helder	nl
dht	dalhart	us
dib	dibrugarh	in
die	antsiranana	mg
dig	diqing	cn
dij	dijon	fr
dik	dickinson	us
dil	dili	tl
dim	dimbokro	ci
din	dien bien phu	vn
dio	diomede island	us
dip	diapaga	bf
diq	divinopolis	br
dir	dire dawa	et
dis	loubomo	cg
diu	diu	in
div	divo	ci
diw	dickwella	lk
diy	diyarbakir	tr
dja	djougou	bj
djb	jambi	id
dje	djerba	tn
djg	djanet	dz
djj	jayapura	id
djm	djambala	cg
djn	delta junction	us
djo	daloa	ci
dju	djupivogur	is
dka	katsina	ng
dki	dunk island	au
dkk	dunkirk	us
dkl	kiwigana lodge	ca
dkr	dakar	sn
dks	dikson	ru
dkv	docker river	au
dla	douala	cm
dlb	dalbertis	pg
dlc	dalian	cn
dle	dole	fr
dlg	dillingham	us
dlh	duluth	us
dli	dalat	vn
dlk	dulkaninna	au
dll	dillon	us
dlm	dalaman	tr
dln	dillon	us
dlo	dolomi	us
dls	the dalles	us
dlu	dali city	cn
dlv	delissaville	au
dly	dillons bay	vu
dlz	dalanzadgad	mn
dmb	zhambyl	kz
dmd	doomadgee	au
dmm	dammam	sa
dmn	deming	us
dmo	sedalia	us
dmr	dhamar	ye
dmt	diamantino	br
dmu	dimapur	in
dnb	dunbar	au
dnd	dundee	gb
dnf	derna	ly
dng	doongan	au
dnh	dunhuang	cn
dni	wad medani	sd
dnk	dnepropetrovsk	ua
dnm	denham	au
dnn	dalton	us
dno	dianopolis	br
dnp	dang	np
dnq	deniliquin	au
dnr	dinard	fr
dns	denison	us
dnu	dinangat	pg
dnv	danville	us
dnx	dinder	sd
dnz	denizli	tr
doa	doany	mg
dob	dobo	id
doc	dornoch	gb
dod	dodoma	tz
doe	djoemoe	sr
dof	dora bay	us
dog	dongola	sd
doh	doha	qa
doi	doini	pg
dok	donetsk	ua
dol	deauville	fr
dom	dominica	dm
don	dos lagunas	gt
doo	dorobisoro	pg
dop	dolpa	np
dor	dori	bf
dos	dios	pg
dou	dourados	br
dov	dover-cheswold	us
dox	dongara	au
doy	dongying	cn
dpe	dieppe	fr
dpg	dugway	us
dpk	deer park	us
dpl	dipolog	ph
dpo	devonport	au
dps	denpasar	id
dpu	dumpu	pg
dqa	daqing	cn
dra	mercury	us
drb	derby	au
drc	dirico	ao
drd	dorunda station	au
dre	drummond island	us
drf	drift river	us
drg	deering	us
drh	dabra	id
dri	de ridder	us
drj	drietabbetje	sr
drk	drake bay	cr
drn	dirranbandi	au
dro	durango	us
drr	durrie	au
drs	dresden	de
drt	del rio	us
dru	drummond	us
drv	dharavandhoo island	mv
drw	darwin	au
dry	drysdale river	au
dsa	doncaster	gb
dsc	dschang	cm
dsd	la desirade	gp
dse	dessie	et
dsg	dilasag	ph
dsi	destin	us
dsk	dera ismail khan	pk
dsm	des moines	us
dsn	ordos (dongsheng)	cn
dso	sondok	kp
dsv	dansville	us
dta	delta	us
dtd	datadawai	id
dte	daet	ph
dth	death valley	us
dti	diamantina	br
dtl	detroit lakes	us
dtm	dortmund	de
dtr	decatur island	us
dtt	detroit	us
dua	durant	us
dub	dublin	ie
duc	duncan	us
dud	dunedin	nz
due	dundo	ao
duf	corolla	us
dug	douglas	us
dui	duisburg	de
duj	du bois	us
duk	dukuduk	za
dum	dumai	id
dun	dundas	gl
duq	duncan/quam	ca
dur	durban	za
dus	dusseldorf	de
dut	dutch harbor	us
dvd	andavadoaka	mg
dvk	diavik	ca
dvl	devils lake	us
dvn	davenport	us
dvo	davao	ph
dvp	davenport downs	au
dvr	daly river	au
dwa	dwangwa	mw
dwb	soalala	mg
dwd	dawadmi	sa
dwr	dwyer	af
dxb	dubai	ae
dxd	dixie	au
dxr	danbury	us
dya	dysart	au
dyg	dayong	cn
dyl	doylestown	us
dym	diamantina lakes	au
dyr	anadyr	ru
dyu	dushanbe	tj
dyw	daly waters	au
dza	dzaoudzi	yt
dzi	codazzi	co
dzn	zhezkazgan	kz
dzo	durazno	uy
dzu	dazu	cn
eaa	eagle	us
eab	abbse	ye
eae	emae	vu
eal	kwajalein atoll	mh
eam	nejran	sa
ean	wheatland	us
eap	mulhouse	ch
ear	kearney	us
eas	san sebastian	es
eat	wenatchee	us
eau	eau claire	us
eba	elba island	it
ebb	entebbe	ug
ebd	el obeid	sd
ebg	el bagre	co
ebh	el bayadh	dz
ebj	esbjerg	dk
ebl	erbil	iq
ebm	el borma	tn
ebn	ebadon	mh
ebo	ebon	mh
ebs	webster city	us
ebu	st etienne	fr
ebw	ebolowa	cm
eca	east tawas	us
ecg	elizabeth city	us
ech	echuca	au
ecn	lefkosa	cy
eco	el encanto	co
ecr	el charco	co
ecs	newcastle	us
eda	edna bay	us
edb	eldebba	sd
edd	erldunda	au
ede	edenton	us
edg	edgewood	us
edi	edinburgh	gb
edk	el dorado	us
edl	eldoret	ke
edm	la roche	fr
edo	edremit	tr
edq	erandique	hn
edr	edward river	au
edw	edwards	us
eed	needles	us
eek	eek	us
eel	tudela	es
een	keene	us
efb	eight fathom bight	us
efg	efogi	pg
efk	newport	us
efl	kefalonia	gr
efo	east fork	us
efw	jefferson	us
ega	engati	pg
egc	bergerac	fr
ege	vail	us
egl	neghelli	et
egm	sege	sb
egn	geneina	sd
ego	belgorod	ru
egp	eagle pass	us
egs	egilsstadir	is
egv	eagle river	us
egx	egegik	us
ehl	el bolson	ar
ehm	cape newenham	us
eht	east hartford	us
eia	eia	pg
eib	eisenach	de
eie	eniseysk	ru
eih	einasleigh	au
eik	yeysk	ru
ein	eindhoven	nl
eis	beef island	vg
eiy	ein yahav	il
eja	barrancabermeja	co
ejh	wedjh	sa
ejt	mili atoll	mh
eka	eureka	us
ekb	ekibastuz	kz
ekd	elkedra	au
eke	ekereku	gy
eki	elkhart	us
ekn	elkins	us
eko	elko	us
eks	shakhtersk	ru
ekt	eskilstuna	se
ekx	elizabethtown	us
ela	eagle lake	us
elb	el banco	co
elc	elcho island	au
eld	el dorado	us
ele	el real	pa
elf	el fasher	sd
elg	el golea	dz
elh	north eleuthera	bs
eli	elim	us
elj	el recreo	co
elk	elk city	us
ell	ellisras	za
elm	elmira	us
eln	ellensburg	us
elo	eldorado	ar
elp	el paso	us
elq	buraidah	sa
elr	elelim	id
els	east london	za
elt	tour sinai city	eg
elu	el oued	dz
elv	elfin cove	us
elw	ellamar	us
elx	el tigre	ve
ely	ely	us
elz	wellsville	us
emd	emerald	au
eme	emden	de
emg	empangeni	za
emi	emirau	pg
emk	emmonak	us
eml	luzern	ch
emm	kemerer	us
emn	nema	mr
emo	emo	pg
emp	emporia	us
ems	embessa	pg
emt	el monte	us
emx	el maiten	ar
emy	el minya	eg
ena	kenai	us
enb	eneabba west	au
ene	ende	id
enf	enontekio	fi
enh	enshi	cn
eni	el nido	ph
enj	el naranjo	gt
enk	enniskillen	gb
enl	centralia	us
enn	nenana	us
eno	encarnacion	py
enq	coronel e soto cano ab	hn
ens	enschede	nl
ent	enewetak island	mh
enu	enugu	ng
env	wendover	us
enw	kenosha	us
eny	yan'an	cn
eoi	eday	gb
eok	keokuk	us
eor	el dorado	ve
eos	neosho	us
eoz	elorza	ve
epa	el palomar	ar
epg	weeping water	us
eph	ephrata	us
epi	epi	vu
epl	epinal	fr
epn	epena	cg
epr	esperance	au
eps	samana	do
ept	eliptamin	pg
epu	parnu	ee
eqs	esquel	ar
era	erigavo	so
erb	ernabella	au
erc	erzincan	tr
erd	berdyansk	ua
ere	erave	pg
erf	erfurt	de
erg	yerbogachen	ru
erh	er-rachidia	ma
eri	erie	us
erl	erenhot	cn
erm	erechim	br
ern	eirunepe	br
ero	eldred rock	us
erq	elrose mine	au
err	errol	us
ert	erdenet	mn
eru	erume	pg
erv	kerrville	us
erz	erzurum	tr
esa	esa'ala	pg
esc	escanaba	us
esd	eastsound	us
ese	ensenada	mx
esg	mariscal estigarribia	py
esh	shoreham by sea	gb
esi	espinosa	br
esk	eskisehir	tr
esl	elista	ru
esm	esmeraldas	ec
esn	easton	us
eso	espanola	us
esp	east stroudsburg	us
esr	el salvador	cl
ess	essen	de
est	estherville	us
esu	essaouira	ma
esw	easton	us
etb	west bend	us
etd	etadunna	au
ete	genda wuha	et
eth	eilat	il
etn	eastland	us
etr	santa rosa	ec
ets	enterprise	us
etz	metz	fr
eua	eua	to
euc	eucla	au
eue	eureka	us
euf	eufaula	us
eug	eugene	us
eum	neumuenster	de
eun	laayoune	ma
euo	paratebueno	co
euq	antique	ph
eux	st eustatius	bq
eva	evadale	us
evd	eva downs	au
eve	harstad-narvik	no
evg	sveg	se
evh	evans head	au
evm	eveleth	us
evn	yerevan	am
evv	evansville	us
evw	evanston	us
evx	evreux	fr
ewb	new bedford	us
ewd	wildman lake	us
ewe	ewer	id
ewi	enarotali	id
ewk	newton	us
ewn	new bern	us
ewo	ewo	cg
ewr	newark	us
exi	excursion inlet	us
exm	exmouth gulf	au
ext	exeter	gb
eyk	beloyarsky	ru
eyl	yelimane	ml
eyp	el yopal	co
eyr	yerington	us
eys	eliye springs	ke
eyw	key west	us
ezs	elazig	tr
ezv	berezovo	ru
faa	faranah	gn
fab	farnborough	gb
fac	faaite	pf
fae	sorvágur	fo
faf	fort eustis	us
fag	fagurholsmyri	is
fah	farah	af
fai	fairbanks	us
faj	fajardo	pr
fak	false island	us
fal	roma	us
fam	farmington	us
fao	faro	pt
faq	freida river	pg
far	fargo	us
fas	faskrudsfjordur	is
fat	fresno	us
fau	fahud	om
fav	fakarava	pf
fay	fayetteville	us
faz	fasa	ir
fba	fonte boa	br
fbd	faizabad	af
fbe	francisco beltrao	br
fbg	fort bragg	us
fbl	faribault	us
fbm	lubumbashi	cd
fbr	fort bridger	us
fbs	friday harbor	us
fby	fairbury	us
fca	kalispell	us
fcb	ficksburg	za
fcn	cuxhaven	de
fcy	forrest city	us
fde	forde	no
fdf	fort de france	mq
fdh	friedrichshafen	de
fdk	frederick	us
fdr	frederick	us
fdu	bandundu	cd
fdy	findlay	us
fea	fetlar	gb
feb	sanfebagar	np
fec	feira de santana	br
feg	fergana	uz
fej	feijo	br
fek	ferkessedougou	ci
fel	fuerstenfeldbruck	de
fen	fernando de noronha	br
fep	freeport	us
fes	san fernando	es
fet	fremont	us
fez	fez	ma
ffa	kill devil hills	us
ffd	fairford	gb
ffl	fairfield	us
ffm	fergus falls	us
fft	frankfort	us
ffu	futaleufu	cl
fgd	fderik	mr
fgl	fox glacier	nz
fgr	fuengirola	es
fgu	fangatau	pf
fhu	sierra vista	us
fhz	fakahina	pf
fic	fire cove	us
fid	fishers island	us
fie	fair isle	gb
fig	fria	gn
fih	kinshasa	cd
fik	finke	au
fil	fillmore	us
fin	finschhafen	pg
fiv	five finger coast guard heliport	us
fiz	fitzroy crossing	au
fjr	al-fujairah	ae
fkb	karlsruhe	de
fki	kisangani	cd
fkj	fukui	jp
fkl	franklin	us
fkn	franklin	us
fkq	fak fak	id
fks	fukushima	jp
fla	florencia	co
flb	floriano	br
flc	falls creek	au
fld	fond du lac	us
flf	flensburg	de
flh	flotta	gb
fli	flateyri	is
flj	falls bay	us
fll	fort lauderdale	us
flm	filadelfia	py
fln	florianopolis	br
flo	florence	us
flp	flippin	us
flr	florence	it
fls	flinders island	au
flt	flat	us
flv	fort leavenworth	us
flw	flores island	pt
fly	finley	au
fma	formosa	ar
fmc	five mile	us
fme	fort meade	us
fmg	flamingo	cr
fmh	falmouth	us
fmi	kalemie	cd
fmm	memmingen	de
fmn	farmington	us
fmo	greven	de
fms	fort madison	us
fmu	florence	us
fmy	fort myers	us
fna	freetown	sl
fnb	neubrandenburg	de
fnc	funchal	pt
fne	fane	pg
fng	fada ngourma	bf
fnh	fincha	et
fni	nimes	fr
fnj	pyongyang	kp
fnk	fin creek	us
fnl	fort collins	us
fnr	funter bay	us
fnt	flint	us
fnu	oristano	it
foa	foula	gb
fob	fort bragg	us
foc	fuzhou	cn
fod	fort dodge	us
fog	foggia	it
fok	westhampton	us
fom	foumban	cm
fon	fortuna	cr
foo	numfoor	id
fop	forest park	us
for	fortaleza	br
fos	forrest	au
fot	forster	au
fou	fougamou	ga
fox	fox	us
foy	foya	lr
fpo	freeport	bs
fpr	fort pierce	us
fpy	perry	us
fra	frankfurt	de
frb	forbes	au
frc	franca	br
frd	friday harbor	us
fre	fera island	sb
frg	farmingdale	us
frh	french lick	us
fri	fort riley	us
frk	fregate island	sc
frl	forli	it
frm	fairmont	us
frn	fort richardson	us
fro	floro	no
frp	fresh water bay	us
frq	feramin	pg
frr	front royal	us
frs	flores	gt
frt	frutillar	cl
fru	bishkek	kg
frw	francistown	bw
fry	fryeburg	us
frz	fritzlar	de
fsc	figari	fr
fsd	sioux falls	us
fsi	fort sill	us
fsk	fort scott	us
fsl	fossil downs	au
fsm	fort smith	us
fsn	fort sheridan	us
fsp	st pierre	pm
fss	forres	gb
fst	fort stockton	us
fsu	fort sumner	us
fsz	shizuoka	jp
fta	futuna island	vu
fte	el calafate	ar
fti	fitiuta	as
ftk	fort knox	us
ftl	fortuna ledge	us
ftu	fort dauphin	mg
ftw	fort worth	us
ftx	owando	cg
fub	fulleborn	pg
fue	puerto del rosario	es
fug	fuyang	cn
fuj	fukue	jp
fuk	fukuoka	jp
ful	fullerton	us
fum	fuma	pg
fun	funafuti atoll	tv
fuo	fuoshan	cn
fut	futuna island	wf
fvl	flora valley	au
fvm	fuvahmulak	mv
fvr	forrest river	au
fwa	fort wayne	us
fwl	farewell	us
fwm	fort william	gb
fxm	flaxman island	us
fxo	cuamba	mz
fxy	forest city	us
fym	fayetteville	us
fyt	faya	td
fyu	fort yukon	us
fyv	fayetteville	us
fzo	filton	gb
gaa	guamal	co
gab	gabbs	us
gac	gracias	hn
gad	gadsden	us
gae	gabes	tn
gaf	gafsa	tn
gag	gage	us
gah	gayndah	au
gai	gaithersburg	us
gaj	yamagata	jp
gak	gakona	us
gal	galena	us
gam	gambell	us
gan	gan island	mv
gao	guantanamo	cu
gap	gusap	pg
gaq	gao	ml
gar	garaina	pg
gas	garissa	ke
gat	gap	fr
gau	gawahati	in
gav	gag island	id
gaw	gangaw	mm
gax	gamba	ga
gay	gaya	in
gaz	guasopa	pg
gba	big bay	vu
gbb	gabala	az
gbc	gasuke	pg
gbd	great bend	us
gbe	gaborone	bw
gbf	negarbo	pg
gbg	galesburg	us
gbh	galbraith lake	us
gbi	grand bahama	bs
gbj	marie galante	gp
gbk	gbangbatok	sl
gbl	goulburn island	au
gbm	garbaharey	so
gbn	san giovanni rotondo	it
gbp	gamboola	au
gbr	great barrington	us
gbs	port fitzroy	nz
gbt	gorgan	ir
gbu	khashm el girba	sd
gbv	gibb river	au
gbz	great barrier island	nz
gca	guacamaya	co
gcc	gillette	us
gcd	electric city	us
gch	gachsaran	ir
gci	guernsey	gg
gck	garden city	us
gcm	georgetown	ky
gcn	grand canyon	us
gcv	gravatai	br
gcw	grand canyon west	us
gcy	greenville	us
gda	gounda	cf
gdd	gordon downs	au
gde	gode	et
gdg	magdagachi	ru
gdh	golden horn lodge	us
gdi	gordil	cf
gdj	gandajika	cd
gdl	guadalajara	mx
gdm	gardner	us
gdn	gdansk	pl
gdo	guasdualito	ve
gdp	guadalupe	br
gdq	gondar	et
gdt	grand turk island	tc
gdv	glendive	us
gdw	gladwin	us
gdx	magadan	ru
gdz	gelendzik	ru
geb	gebe	id
gec	gecitkale	cy
ged	georgetown	us
gee	george town	au
gef	geva	sb
geg	spokane	us
gei	green islands	pg
gek	ganes creek	us
gel	santo angelo	br
gen	puente genil	es
geo	georgetown	gy
ger	nueva gerona	cu
ges	general santos	ph
get	geraldton	au
gev	gallivare	se
gew	gewoia	pg
gex	geelong	au
gey	greybull	us
gfb	togiak fish	us
gfd	greenfield	us
gfe	grenfell	au
gff	griffith	au
gfk	grand forks	us
gfl	glens falls	us
gfn	grafton	au
gfo	bartica	gy
gfr	granville	fr
gfy	grootfontein	na
gga	la graciosa	es
ggc	lumbala	ao
ggd	gregory downs	au
gge	georgetown	us
ggg	kilgore	us
ggl	gilgal	co
ggm	kakamega	ke
ggn	gagnoa	ci
ggo	guiglo	ci
ggr	garoe	so
ggs	gobernador gregores	ar
ggt	george town	bs
ggw	glasgow	us
gha	ghardaïa	dz
ghb	governors harbour	bs
ghc	great harbour	bs
ghe	garachine	pa
ghf	giebelstadt	de
ghm	centerville	us
ghn	guanghan	cn
ght	ghat	ly
ghu	gualeguaychu	ar
gib	gibraltar	gi
gic	boigu island	au
gid	gitega	bi
gif	winter haven	us
gii	siguiri	gn
gil	gilgit	pk
gim	miele mimbale	ga
gir	girardot	co
gis	gisborne	nz
git	geita	tz
giu	sigiriya	lk
giy	giyani	za
giz	jazan	sa
gja	guanaja	hn
gjl	jijel	dz
gjm	guajara-mirim	br
gjr	gjogur	is
gjt	grand junction	us
gka	goroka	pg
gkd	gokceada	tr
gke	geilenkirchen	de
gkh	gorkha	np
gkl	great keppel island	au
gkn	gulkana	us
gko	kongoboumba	ga
gkt	gatlinburg	us
gla	glasgow	gb
glb	globe	us
glc	geladi	et
gld	goodland	us
gle	gainesville	us
glf	golfito	cr
glg	glengyle	au
glh	greenville	us
gli	glen innes	au
glk	galcaio	so
gll	gol	no
glm	glenormiston	au
gln	goulimime	ma
glo	gloucester	gb
glp	gulgubip	pg
glq	glennallen	us
glr	gaylord	us
gls	galveston	us
glt	gladstone	au
glv	golovin	us
glw	glasgow	us
glx	galela	id
gly	goldsworthy	au
glz	breda	nl
gma	gemena	cd
gmb	gambela	et
gmc	guerima	co
gmd	ben slimane	ma
gme	gomel	by
gmi	gasmata island	pg
gmm	gamboma	cg
gmn	greymouth	nz
gmo	gombe	ng
gmr	gambier island	pf
gms	guimaraes	br
gmt	granite mountain	us
gmv	monument valley gldngs	us
gmz	san sebas de la gomera	es
gna	grodna	by
gnd	st. georges	gd
gnf	quincy	us
gng	gooding	us
gni	green island	tw
gnm	guanambi	br
gnn	ghinnir	et
gnr	general roca	ar
gns	gunungsitoli	id
gnt	grants	us
gnu	goodnews bay	us
gnv	gainesville	us
gnz	ghanzi	bw
goa	genova	it
gob	goba	et
goc	gora	pg
goe	gonalia	pg
gog	gobabis	na
goh	nuuk	gl
goi	goa	in
goj	nizhniy novgorod	ru
gok	guthrie	us
gol	gold beach	us
gom	goma	cd
gon	new london	us
goo	goondiwindi	au
gop	gorakhpur	in
goq	golmud	cn
gor	gore	et
gos	gosford	au
got	gothenburg	se
gou	garoua	cm
gov	gove	au
goy	gal oya	lk
goz	gorna oriahovitsa	bg
gpa	patras	gr
gpb	guarapuava	br
gpd	mount gordon mine	au
gpi	guapi	co
gpl	guapiles	cr
gpn	garden point	au
gpo	general pico	ar
gps	galapagos island	ec
gpt	gulfport	us
gpz	grand rapids	us
gqq	galion	us
gra	gamarra	co
grb	green bay	us
grc	grand cess	lr
grd	greenwood	us
gre	greenville	us
grg	gardez	af
grh	garuahi	pg
gri	grand island	us
grj	george	za
grl	garasa	pg
grm	grand marais	us
grn	gordon	us
gro	gerona	es
grp	gurupi	br
grq	groningen	nl
grr	grand rapids	us
grs	grosseto	it
grt	gujrat	pk
grv	groznyj	ru
grw	graciosa island	pt
grx	granada	es
gry	grimsey	is
grz	graz	at
gsa	long pasia	my
gsb	goldsboro	us
gsc	gascoyne junction	au
gsh	goshen	us
gsi	guadalcanal	sb
gsj	puerto san jose	gt
gsl	taltheilei narrows	ca
gsm	gheshm	ir
gsn	mount gunson	au
gso	greensboro	us
gsp	greenville	us
gsq	shark elowainat	eg
gsr	gardo	so
gss	sabi sabi	za
gst	gustavus	us
gsu	gedaref	sd
gsy	grimsby	gb
gta	gatokae	sb
gtb	genting	my
gtc	green turtle	bs
gte	groote eylandt	au
gtf	great falls	us
gtg	grantsburg	us
gti	guettin	de
gtk	sungei tekai	my
gto	gorontalo	id
gtp	grants pass	us
gts	granites	au
gtt	georgetown	au
gtw	zlin	cz
gty	gettysburg	us
gtz	grumeti	tz
gua	guatemala city	gt
gub	guerrero negro	mx
guc	gunnison	us
gud	goundam	ml
gue	guriaso	pg
guf	gulf shores	us
gug	guari	pg
guh	gunnedah	au
gui	guiria	ve
guj	guaratingueta	br
gul	goulburn	au
gum	agana	gu
guo	gualaco	hn
gup	gallup	us
guq	guanare	ve
gur	alotau	pg
gus	peru	us
gut	guetersloh	de
guu	grundarfjordur	is
guv	mougulu	pg
guw	atyrau	kz
gux	guna	in
guy	guymon	us
gva	geneva	ch
gve	gordonsville	us
gvi	green river	pg
gvl	gainesville	us
gvn	sovetskaya gavan	ru
gvp	greenvale	au
gvr	governador valadares	br
gvt	greenville	us
gvw	grandview	us
gvx	gavle	se
gwa	gwa	mm
gwd	gwadar	pk
gwe	gweru	zw
gwl	gwalior	in
gwn	gnarowein	pg
gwo	greenwood	us
gws	glenwood springs	us
gwt	westerland	de
gwv	glendale	us
gwy	galway	ie
gxf	seiyun	ye
gxg	negage	ao
gxq	coyhaique	cl
gxx	yagoua	cm
gxy	greeley	us
gya	guayaramerin	bo
gye	guayaquil	ec
gyi	gisenyi	rw
gyl	argyle	au
gym	guaymas	mx
gyn	goiania	br
gyp	gympie	au
gyr	goodyear	us
gys	guang yuan	cn
gyu	guyuan	cn
gyy	gary	us
gza	rafah	ps
gzi	ghazni	af
gzm	gozo	mt
gzo	gizo	sb
gzp	alanya	tr
gzt	gaziantep	tr
gzw	ghazvin	ir
haa	hasvik	no
hab	hamilton	us
hac	hachijo jima	jp
had	halmstad	se
hae	havasupai	us
haf	half moon	us
hag	the hague	nl
hai	three rivers	us
haj	hanover	de
hak	haikou	cn
hal	halali	na
ham	hamburg	de
han	hanoi	vn
hao	hamilton	us
hap	long island	au
haq	hanimaadhoo	mv
har	harrisburg	us
has	hail	sa
hat	heathlands	au
hau	haugesund	no
hav	havana	cu
haw	haverfordwest	gb
hay	haycock	us
haz	hatzfeldthaven	pg
hba	hobart	au
hbc	hanus bay	us
hbd	habi	pg
hbg	hattiesburg	us
hbh	hobart bay	us
hbi	harbour island	bs
hbk	holbrook	us
hbn	phu-bon	vn
hbo	humboldt	us
hbr	hobart	us
hbu	"bulgan, hovd"	mn
hbx	hubli	in
hca	big spring	us
hcb	shoal cove	us
hcc	hudson	us
hcm	eil	so
hcn	hengchun	tw
hcq	halls creek	au
hcr	holy cross	us
hcw	cheraw	us
hda	hidden falls	us
hdb	heidelberg	de
hdd	hyderabad	pk
hde	holdrege	us
hdf	heringsdorf	de
hdg	handan	cn
hdh	oahu	us
hdm	hamadan	ir
hdn	hayden	us
hdr	havadarya	ir
hds	hoedspruit	za
hdy	hat yai	th
hea	herat	af
heb	henzada	mm
hed	herendeen	us
hee	helena	us
heh	heho	mm
hei	heide-buesum	de
hek	heihe	cn
hel	helsinki	fi
heo	haelogo	pg
her	heraklion	gr
hes	hermiston	us
het	hohhot	cn
hev	huelva	es
hez	natchez	us
hfa	haifa	il
hfd	hartford	us
hfe	hefei (luogang airport)	cn
hff	hoffman	us
hfn	hornafjordur	is
hfs	hagfors	se
hft	hammerfest	no
hga	hargeisa	so
hgd	hughenden	au
hgh	hangzhou	cn
hgi	higlieg	sd
hgl	helgoland	de
hgn	mae hong son	th
hgo	korhogo	ci
hgr	hagerstown	us
hgt	jolon	us
hgu	mount hagen	pg
hgz	hogatza	us
hhe	hachinohe	jp
hhh	hilton head	us
hhi	wahiawa	us
hhq	hua hin	th
hhr	hawthorne	us
hhz	hikueru	pf
hia	huai'an	cn
hib	chisholm	us
hid	horn island	au
hie	whitefield	us
hig	highbury	au
hih	hook island	au
hii	lake havasu city	us
hij	hiroshima	jp
hil	shillavo	et
him	hingurakgoda	lk
hin	jinju	kr
hio	hillsboro	us
hip	headingly	au
hir	honiara	sb
his	hayman island	au
hit	hivaro	pg
hjj	zhi jiang	cn
hjr	khajuraho	in
hjt	khujirt	mn
hkb	healy lake	us
hkd	hakodate	jp
hkg	hong kong	hk
hkk	hokitika	nz
hkn	hoskins	pg
hkt	phuket	th
hkv	haskovo	bg
hky	hickory	us
hlb	batesville	us
hlc	hill city	us
hld	hailar	cn
hlf	hultsfred	se
hlg	wheeling	us
hlh	ulanhot	cn
hli	hollister	us
hll	hillside	au
hlm	holland	us
hln	helena	us
hls	st helens	au
hlt	hamilton	au
hlu	houailou	nc
hlv	helenvale	au
hlw	hluhluwe	za
hly	holyhead	gb
hlz	hamilton	nz
hma	khanty-mansiysk	ru
hmb	sohag	eg
hme	hassi messaoud	dz
hmg	hermannsburg	au
hmi	hami	cn
hmj	khmelnitskiy	ua
hmo	hermosillo	mx
hmr	hamar	no
hms	homeshore	us
hmt	hemet	us
hmv	hemavan	se
hna	hanamaki	jp
hnb	huntingburg	us
hnc	hatteras	us
hne	tahneta pass lodge	us
hng	hienghene	nc
hnh	hoonah	us
hni	heiweni	pg
hnl	honolulu	us
hnm	hana	us
hnn	honinabi	pg
hns	haines	us
hnx	hanna	us
hny	hengyang	cn
hoa	hola	ke
hob	hobbs	us
hoc	komako	pg
hod	hodeidah	ye
hoe	houeisay	la
hof	alahsa	sa
hog	holguin	cu
hoh	hohenems	at
hoi	hao island	pf
hok	hooker creek	au
hol	holikachu	us
hom	homer	us
hon	huron	us
hoo	quanduc	vn
hop	hopkinsville	us
hoq	hof	de
hor	horta	pt
hos	chos malal	ar
hot	hot springs	us
hou	houston	us
hov	orsta-volda	no
how	fort kobbe	pa
hox	homalin	mm
hoy	hoy island	gb
hpa	ha'apai	to
hpb	hooper bay	us
hpe	hope vale	au
hph	haiphong	vn
hpn	westchester county	us
hpt	hampton	us
hpy	baytown	us
hqm	hoquiam	us
hra	mansehra	pk
hrb	harbin	cn
hrc	zhairem	kz
hre	harare	zw
hrg	hurghada	eg
hri	hambantota	lk
hrj	chaurjhari	np
hrk	kharkov	ua
hrl	harlingen	us
hrm	hassi r'mel	dz
hrn	heron island	au
hro	harrison	us
hrr	herrera	co
hrs	harrismith	za
hrt	harrogate	gb
hry	henbury	au
hrz	horizontina	br
hsb	harrisburg	us
hsc	shaoguan	cn
hsg	saga	jp
hsi	hastings	us
hsk	huesca	es
hsl	huslia	us
hsm	horsham	au
hsn	zhoushan	cn
hsp	hot springs	us
hss	hissar	in
hst	homestead	us
hsv	huntsville	us
hsz	hsinchu	tw
hta	chita	ru
htb	terre-de-bas	gp
htg	hatanga	ru
hth	hawthorne	us
hti	hamilton island	au
htl	houghton	us
htm	khatgal	mn
htn	hotan	cn
hto	east hampton	us
htr	hateruma	jp
hts	huntington	us
htu	hopetoun	au
htv	huntsville	us
htw	huntington	us
hty	hatay	tr
htz	hato corozal	co
hub	humbert river	au
huc	humacao	pr
hud	humboldt	us
hue	humera	et
huf	terre haute	us
hug	huehuetenango	gt
huh	huahine	pf
hui	hue	vn
huj	hugo	us
huk	hukuntsi	bw
hul	houlton	us
hum	houma	us
hun	hualien	tw
huq	houn	ly
hus	hughes	us
hut	hutchinson	us
huu	huanuco	pe
huv	hudiksvall	se
huw	humaita	br
hux	huatulco	mx
huy	humberside	gb
huz	huizhou	cn
hva	analalava	mg
hvb	hervey bay	au
hvd	khovd	mn
hve	hanksville	us
hvg	honningsvag	no
hvk	holmavik	is
hvn	new haven	us
hvr	havre	us
hvs	hartsville	us
hvz	heviz	hu
hwa	hawabango	pg
hwd	hayward	us
hwi	hawk inlet	us
hwk	hawker	au
hwn	hwange nat park	zw
hwo	hollywood	us
hxx	hay	au
hya	hyannis	us
hyc	high wycombe	gb
hyd	hyderabad	in
hyf	hayfields	pg
hyg	hydaburg	us
hyl	hollis	us
hyn	taizhou	cn
hyr	hayward	us
hys	hays	us
hyv	hyvinkaa	fi
hzb	hazebrouck	fr
hzg	hanzhong	cn
hzh	liping city	cn
hzk	husavik	is
hzl	hazleton	us
hzp	fort mackay	ca
hzv	hazyview	za
iaa	igarka	ru
iag	niagara falls	us
iam	in amenas	dz
ian	kiana	us
iao	del carmen	ph
iaq	bahregan	ir
iar	yaroslavl	ru
ias	iasi	ro
iau	iaura	pg
iba	ibadan	ng
ibb	isabela island	ec
ibe	ibague	co
ibi	iboki	pg
ibl	indigo bay lodge	mz
ibo	ibo	mz
ibp	iberia	pe
ibr	ibaraki	jp
ibz	ibiza	es
ica	icabaru	ve
ici	cicia	fj
ick	nieuw nickerie	sr
icl	clarinda	us
ico	sicogon island	ph
icr	nicaro	cu
ics	cascade	us
ict	wichita	us
icy	icy bay	us
ida	idaho falls	us
idb	idre	se
idc	ila da chilonzuene	mz
idf	idiofa	cd
idg	ida grove	us
idh	grangeville	us
idi	indiana	us
idk	indulkana	au
idn	indagen	pg
ido	santa isabel do morro	br
idp	independence	us
idr	indore	in
idy	ile d'yeu	fr
ieg	zielona gora	pl
iej	iejima	jp
ies	riesa	de
iev	kiev	ua
ifa	iowa falls	us
iff	iffley	au
ifh	hesa	ir
ifj	isafjordur	is
ifl	innisfail	au
ifn	isfahan	ir
ifo	ivano-frankovsk	ua
ifp	bullhead city	us
iga	inagua	bs
igb	ingeniero jacobacci	ar
igd	igdir	tr
ige	iguela	ga
igg	igiugig	us
igh	ingham	au
igm	kingman	us
ign	iligan	ph
igo	chigorodo	co
igr	iguazu	ar
igs	ingolstadt-manching	de
igt	nazran	ru
igu	iguassu falls	br
iha	niihama	jp
ihc	inhaca	mz
ihn	qishn	ye
iho	ihosy	mg
ihr	iran shahr	ir
ihu	ihu	pg
iia	galloway	ie
iil	ilaam	ir
iin	nishinoomote	jp
iis	nissan island	pg
ijk	izhevsk	ru
iju	ijui	br
ijx	jacksonville	us
ikb	wilkesboro	us
iki	iki	jp
ikk	kankakee	us
ikl	ikela	cd
iko	nikolski	us
ikp	inkerman	au
iks	tiksi	ru
ikt	irkutsk	ru
ila	illaga	id
ilb	ilha solteira	br
ild	lleida	es
ile	killeen	us
ilf	ilford	ca
ilg	wilmington	us
ilh	illisheim	de
ili	iliamna	us
ilk	ilaka	mg
ill	willmar	us
ilm	wilmington	us
iln	wilmington	us
ilo	iloilo	ph
ilp	ile des pins	nc
ilq	ilo	pe
ilr	ilorin	ng
ilu	kilaguni	ke
ilx	ileg	pg
ily	islay	gb
ilz	zilina	sk
ima	iamalele	pg
imb	imbaimadai	gy
imd	imonda	pg
imf	imphal	in
img	inhaminga	mz
imi	ine island	mh
imk	simikot	np
iml	imperial	us
imm	immokalee	us
imn	imane	pg
imo	zemio	cf
imp	imperatriz	br
imt	iron mountain	us
ina	inta	ru
inb	independence	bz
inc	yinchuan	cn
ind	indianapolis	us
ine	chinde	mz
inf	in guezzam	dz
ing	lago argentino	ar
inh	inhambane	mz
ini	nis	rs
inj	injune	au
ink	wink	us
inl	international falls	us
inm	innamincka	au
inn	innsbruck	at
ino	inongo	cd
inq	inisheer	ie
ins	indian springs	us
int	winston salem	us
inu	nauru island	nr
inv	inverness	gb
inw	winslow	us
inx	inanwatan	id
iny	inyati	za
inz	in salah	dz
ioa	ioannina	gr
iok	iokea	pg
iom	isle of man	im
ion	impfondo	cg
iop	ioma	pg
ior	inishmore	ie
ios	ilheus	br
iou	ile ouen	nc
iow	iowa city	us
ipa	ipota	vu
ipc	easter island	cl
ipe	ipil	ph
ipg	ipiranga	br
iph	ipoh	my
ipi	ipiales	co
ipl	imperial	us
ipn	ipatinga	br
ipt	williamsport	us
ipu	ipiau	br
ipw	ipswich	gb
iqa	al asad	iq
iqm	qiemo	cn
iqn	qingyang	cn
iqq	iquique	cl
iqt	iquitos	pe
ira	kirakira	sb
irb	iraan	us
irc	circle	us
ird	ishurdi	bd
ire	irece	br
irg	lockhart river	au
iri	iringa	tz
irj	la rioja	ar
irk	kirksville	us
irm	igrim	ru
irn	iriona	hn
iro	birao	cf
irp	isiro	cd
irs	sturgis	us
iru	iranamadu	lk
irz	santa isabel rio negro	br
isa	mount isa	au
isb	islamabad	pk
isc	"st marys, isles of scilly"	gb
isd	iscuande	co
ise	isparta	tr
isg	ishigaki	jp
ish	ischia	it
isi	isisford	au
isj	isla mujeres	mx
isk	nasik	in
isl	isabel pass	us
ism	kissimmee	us
isn	williston	us
iso	kinston	us
isp	islip	us
isq	manistique	us
iss	wiscasset	us
ist	istanbul	tr
isu	sulaimaniyah	iq
isw	wisconsin rapids	us
ita	itacoatiara	br
itb	itaituba	br
ite	itubera	br
ith	ithaca	us
iti	itambacuri	br
itk	itokama	pg
itn	itabuna	br
ito	hilo	us
itp	itaperuna	br
itq	itaqui	br
itr	itumbiara	br
iue	niue island	nu
iul	ilu	id
ium	summit lake	ca
ius	inus	pg
iva	ambanja	mg
ivc	invercargill	nz
ivg	berane	me
ivh	ivishak	us
ivi	isla viveros	pa
ivl	ivalo	fi
ivo	chivolo	co
ivr	inverell	au
ivw	inverway	au
iwa	ivanova	ru
iwd	ironwood	us
iwj	iwami	jp
iwk	iwakuni	jp
iwo	iwo jima vol	jp
ixa	agartala	in
ixb	bagdogra	in
ixc	chandigarh	in
ixd	allahabad	in
ixe	mangalore	in
ixg	belgaum	in
ixh	kailashahar	in
ixi	lilabari	in
ixj	jammu	in
ixk	keshod	in
ixl	leh	in
ixm	madurai	in
ixn	khowai	in
ixp	pathankot	in
ixq	kamalpur	in
ixr	ranchi	in
ixs	silchar	in
ixt	pasighat	in
ixu	aurangabad	in
ixv	along	in
ixw	jamshedpur	in
ixy	kandla	in
ixz	port blair	in
iyk	inyokern	us
izm	izmir	tr
izo	izumo	jp
izt	ixtepec	mx
jaa	jalalabad	af
jab	jabiru	au
jac	jackson	us
jaf	jaffna	lk
jag	jacobabad	pk
jai	jaipur	in
jak	jacmel	ht
jal	jalapa	mx
jam	jambol	bg
jan	jackson	us
jap	punta renes	cr
jaq	jacquinot bay	pg
jar	jahrom	ir
jas	jasper	us
jat	jabot	mh
jau	jauja	pe
jav	ilulissat	gl
jax	jacksonville	us
jbk	berkeley	us
jbq	higuero	do
jbr	jonesboro	us
jbs	pleasanton	us
jcb	joacaba	br
jch	qasigiannguit	gl
jck	julia creek	au
jcm	jacobina	br
jcn	incheon	kr
jco	comino	mt
jcr	jacareacanga	br
jct	junction	us
jcu	ceuta	es
jcy	johnson	us
jda	john day	us
jdf	juiz de fora	br
jdg	jeongseok	kr
jdh	jodhpur	in
jdn	jordan	us
jdo	juazeiro do norte	br
jdr	sao joao del rei	br
jdy	downey	us
jdz	jingdezhen	cn
jed	jeddah	sa
jee	jeremie	ht
jef	jefferson city	us
jeg	aasiaat	gl
jej	jeh	mh
jem	emeryville	us
jeq	jequie	br
jer	jersey	je
jfm	fremantle	au
jfn	jefferson	us
jfr	paamiut	gl
jga	jamnagar	in
jgb	jagdalpur	in
jgd	jiagedaqi	cn
jge	geoje	kr
jgn	jiayuguan	cn
jgo	qeqertarsuaq	gl
jgr	groennedal	gl
jgs	ji an	cn
jgx	glendale	us
jhb	johor bahru	my
jhc	garden city	us
jhg	jinghong	cn
jhm	lahaina	us
jhs	sisimiut	gl
jhw	jamestown	us
jhy	cambridge	us
jia	juina	br
jib	djibouti	dj
jic	jinchang	cn
jij	jijiga	et
jik	ikaria island	gr
jil	jilin	cn
jim	jimma	et
jin	jinja	ug
jip	jipijapa	ec
jiq	qianjiang	cn
jir	jiri	np
jiu	jiujiang	cn
jiw	jiwani	pk
jja	jajao	sb
jji	juanjui	pe
jjm	meru-kinna	ke
jjn	jinjiang	cn
jju	qaqortoq	gl
jkg	jonkoping	se
jkh	chios	gr
jkl	kalymnos island	gr
jkr	janakpur	np
jkt	jakarta	id
jkv	jacksonville	us
jla	cooper lodge	us
jld	landskrona	se
jlh	arlington heights	us
jln	joplin	us
jlr	jabalpur	in
jls	jales	br
jmb	jamba	ao
jmc	sausalito	us
jmh	schaumburg	us
jmk	mikonos	gr
jmo	jomsom	np
jms	jamestown	us
jmu	jiamusi	cn
jna	januaria	br
jnb	johannesburg	za
jng	jining	cn
jni	junin	ar
jnj	duqm	om
jnn	nanortalik	gl
jnp	newport beach	us
jns	narsaq	gl
jnu	juneau	us
jnx	naxos	gr
jnz	jinzhou	cn
joe	joensuu	fi
jog	yogyakarta	id
joh	port saint johns	za
joi	joinville	br
jok	yoshkar-ola	ru
jol	jolo	ph
jom	njombe	tz
jon	johnston island	um
jop	josephstaal	pg
jor	orange	us
jos	jos	ng
jot	joliet	us
jpa	joao pessoa	br
jpd	pasadena	us
jpr	ji-parana	br
jqa	qaarsut	gl
jqe	jaque	pa
jrf	kapolei	us
jrh	jorhat	in
jrk	arsuk	gl
jrn	juruena	br
jro	kilimanjaro	tz
jrs	jerusalem	il
jsa	jaisalmer	in
jsd	stratford	us
jsh	sitia	gr
jsi	skiathos	gr
jsm	jose de san martin	ar
jso	sodertalje	se
jsr	jessore	bd
jst	johnstown	us
jsu	maniitsoq	gl
jsy	syros island	gr
jtc	bauru	br
jti	jatai	br
jto	thousand oaks	us
jtr	santorini (thira)	gr
jty	astypalaia island	gr
jua	juara	br
jub	juba	ss
juh	chizhou	cn
jui	juist	de
juj	jujuy	ar
jul	juliaca	pe
jum	jumla	np
jun	jundah	au
juo	jurado	co
jur	jurien bay	au
jut	juticalpa	hn
juv	upernavik	gl
juz	juzhou	cn
jva	ankavandra	mg
jvi	manville	us
jvl	janesville	us
jwa	jwaneng	bw
jwn	zanjan	ir
jxa	jixi	cn
jxn	jackson	us
jyr	jiroft	ir
jyv	jyvaskyla	fi
jzh	song pan	cn
kaa	kasama	zm
kab	kariba	zw
kac	kameshli	sy
kad	kaduna	ng
kae	kake	us
kaf	karato	pg
kag	gangneung	kr
kai	kaieteur	gy
kaj	kajaani	fi
kak	kar	pg
kal	kaltag	us
kam	kamaran island	ye
kan	kano	ng
kao	kuusamo	fi
kap	kapanga	cd
kaq	kamulai	pg
kar	kamarang	gy
kas	karasburg	na
kat	kaitaia	nz
kau	kauhava	fi
kav	kavanayen	ve
kaw	kawthaung	mm
kax	kalbarri	au
kay	wakaya island	fj
kaz	kau	id
kba	kabala	sl
kbb	kirkimbie	au
kbc	birch creek	us
kbd	kimberley downs	au
kbe	bell island	us
kbf	karubaga	id
kbg	kabalega falls	ug
kbh	kalat	pk
kbi	kribi	cm
kbj	kings canyon	au
kbk	klag bay	us
kbl	kabul	af
kbm	kabwum	pg
kbn	kabinda	cd
kbo	kabalo	cd
kbq	kasungu	mw
kbr	kota bharu	my
kbs	bo	sl
kbt	kaben	mh
kbu	kotabaru	id
kbv	krabi	th
kbx	kambuaya	id
kby	streaky bay	au
kbz	kaikoura	nz
kca	kuqa	cn
kcb	kasikasima	sr
kcc	coffman cove	us
kcd	kamur	id
kce	collinsville	au
kcf	kadanwari	pk
kch	kuching	my
kci	kon	id
kcj	komaio	pg
kck	kirensk	ru
kcl	chignik	us
kcm	kahramanmaras	tr
kcn	chernofski	us
kco	kocaeli	tr
kcp	kamenets-podolskiy	ua
kcr	colorado creek	us
kcs	kings creek station	au
kct	koggala	lk
kcu	masindi	ug
kcz	kochi	jp
kda	kolda	sn
kdb	kambalda	au
kdc	kandi	bj
kdd	khuzdar	pk
kde	koroba	pg
kdh	kandahar	af
kdi	kendari	id
kdj	ndjole	ga
kdl	kardla	ee
kdm	kaadedhdhoo	mv
kdn	ndende	ga
kdo	kadhdhoo	mv
kdp	kandep	pg
kdq	kamberatoro	pg
kdr	kandrian	pg
kds	kamaran downs	au
kdt	kamphangsaen	th
kdu	skardu	pk
kdv	kandavu	fj
kdw	kandy	lk
kdx	kadugli	sd
kdy	mahaweli	lk
kdz	katugastota	lk
kea	keisah	id
keb	nanwalek	us
kec	kasenga	cd
ked	kaedi	mr
kee	kelle	cg
keg	keglsugl	pg
keh	kenmore air harbor	us
kei	kepi	id
kej	kemerovo	ru
kek	ekwok	us
kel	kiel	de
kem	kemi	fi
ken	kenema	sl
keo	odienne	ci
kep	nepalganj	np
keq	kebar	id
ker	kerman	ir
kes	kelsey	ca
ket	keng tung	mm
keu	kelly bar	us
kev	kuorevesi	fi
kew	keewaywin	ca
kex	kanabea	pg
key	kericho	ke
kez	kelaniya	lk
kfa	kiffa	mr
kfe	cloudbreak	au
kfg	kalkurung	au
kfp	false pass	us
kga	kananga	cd
kgb	konge	pg
kgc	kingscote	au
kgd	kaliningrad	ru
kge	kagau	sb
kgf	karaganda	kz
kgg	kedougou	sn
kgh	yongai	pg
kgi	kalgoorlie	au
kgj	karonga	mw
kgk	new koliganek	us
kgl	kigali	rw
kgm	kungum	pg
kgn	kasongo lunda	cd
kgo	kirovograd	ua
kgp	kogalym	ru
kgr	kulgera	au
kgs	kos	gr
kgt	kangding	cn
kgu	keningau	my
kgw	kagi	pg
kgx	grayling	us
kgy	kingaroy	au
kgz	glacier creek	us
kha	khaneh	ir
khc	kerch	ua
khd	khorramabad	ir
khe	kherson	ua
khg	kashi	cn
khh	kaohsiung	tw
khi	karachi	pk
khj	kauhajoki	fi
khk	khark island	ir
khm	khamti	mm
khn	nanchang	cn
kho	khoka moya	za
khr	kharkhorin	mn
khs	khasab	om
kht	khost	af
khu	kremenchug	ua
khv	khabarovsk	ru
khw	khwai river lodge	bw
khy	khoy	ir
khz	kauehi	pf
kia	kaiapit	pg
kib	ivanof bay	us
kic	king city	us
kid	kristianstad	se
kie	kieta	pg
kif	kingfisher lake	ca
kig	koinghaas	za
kih	kish island	ir
kii	kibuli	pg
kij	niigata	jp
kik	kirkuk	iq
kil	kilwa	cd
kim	kimberley	za
kin	kingston	jm
kio	kili island	mh
kiq	kira	pg
kir	farranfore	ie
kis	kisumu	ke
kit	kithira	gr
kiu	kiunga	ke
kiv	chisinau	md
kiw	kitwe	zm
kiy	kilwa	tz
kiz	kikinonda	pg
kja	krasnojarsk	ru
kji	burqin	cn
kjk	kortrijk	be
kjp	kerama	jp
kju	kamiraba	pg
kka	koyuk	us
kkb	kitoi bay	us
kkc	khon kaen	th
kkd	kokoda	pg
kke	kerikeri	nz
kkf	kagvik creek	us
kkg	konawaruk	gy
kkh	kongiganak	us
kki	akiachak	us
kkj	kita kyushu	jp
kkk	kalakaket	us
kkl	karluk lake	us
kkm	lop buri	th
kkn	kirkenes	no
kko	kaikohe	nz
kkp	koolburra	au
kkq	krasnoselkup	ru
kkr	kaukura atoll	pf
kkt	kentland	us
kku	ekuk	us
kkw	kikwit	cd
kkx	kikaiga shima	jp
kky	kilkenny	ie
kkz	koh kong	kh
klb	kalabo	zm
klc	kaolack	sn
kld	tver	ru
kle	kaele	cm
klf	kaluga	ru
klg	kalskag	us
klh	kolhapur	in
kli	kota koli	cd
klk	kalokol	ke
kll	levelock	us
klm	kalaleh	ir
kln	larsen bay	us
klo	kalibo	ph
klp	kelp bay	us
klq	keluang	id
klr	kalmar	se
kls	kelso	us
klt	kaiserslautern	de
klu	klagenfurt	at
klv	karlovy vary	cz
klw	klawock	us
klx	kalamata	gr
kly	kalima	cd
klz	kleinzee	za
kma	kerema	pg
kmb	koinambe	pg
kmc	king khalid mil. city	sa
kme	kamembe	rw
kmf	kamina	pg
kmg	kunming	cn
kmh	kuruman	za
kmi	miyazaki	jp
kmj	kumamoto	jp
kmk	makabana	cg
kml	kamileroi	au
kmm	kimam	id
kmn	kamina	cd
kmo	manokotak	us
kmp	keetmanshoop	na
kmq	komatsu	jp
kmr	karimui	pg
kms	kumasi	gh
kmt	kampot	kh
kmu	kismayu	so
kmv	kalaymyo	mm
kmw	kostroma	ru
kmx	khamis mushait	sa
kmy	moser bay	us
kmz	kaoma	zm
kna	vina del mar	cl
knb	kanab	us
knd	kindu	cd
kne	kanainj	pg
knf	kings lynn	gb
kng	kaimana	id
knh	kinmen	tw
kni	katanning	au
knj	kindamba	cg
knk	kakhonak	us
knl	kelanoa	pg
knm	kaniama	cd
knn	kankan	gn
knp	capanda	ao
knq	kone	nc
knr	kangan	ir
kns	king island	au
knt	kennett	us
knu	kanpur	in
knv	knights inlet	ca
knw	new stuyahok	us
knx	kununurra	au
kny	kinoosao	ca
knz	kenieba	ml
koa	kona	us
koc	koumac	nc
kod	kotabangun	id
koe	kupang	tl
kof	komatipoort	za
kog	khong	la
koh	koolatah	au
koi	orkney island	gb
koj	kagoshima	jp
kok	kokkola	fi
kol	koumala	cf
kom	komo-manda	pg
kon	kontum	vn
koo	kongolo	cd
kop	nakhon phanom	th
koq	koethen	de
kor	kokoro	pg
kos	sihanoukville	kh
kot	kotlik	us
kou	koulamoutou	ga
kov	kokshetau	kz
kow	ganzhou	cn
kox	kokonao	id
koy	olga bay	us
koz	ouzinkie	us
kpa	kopiago	pg
kpb	point baker	us
kpc	port clarence	us
kpd	king of prussia	us
kpe	yapsiei	pg
kpf	kondubol	pg
kpg	kurupung	gy
kph	pauloff harbor	us
kpi	kapit	my
kpk	parks	us
kpl	kapal	pg
kpm	kompiam	pg
kpn	kipnuk	us
kpo	pohang	kr
kpp	kalpowar	au
kpr	port williams	us
kps	kempsey	au
kpt	jackpot	us
kpv	perryville	us
kpy	port bailey	us
kqa	akutan	us
kql	kol	pg
kqt	qurghonteppa	tj
kra	kerang	au
krb	karumba	au
krc	kerinci	id
krd	kurundi	au
kre	kirundo	bi
krf	kramfors	se
krg	karasabai	gy
kri	kikori	pg
krj	karawari	pg
krk	krakow	pl
krl	korla	cn
krm	karanambo	gy
krn	kiruna	se
kro	kurgan	ru
krp	karup	dk
krq	kramatorsk	ua
krr	krasnodar	ru
krs	kristiansand	no
krt	khartoum	sd
kru	kerau	pg
krv	kerio valley	ke
krw	turkmenbashi	tm
krx	kar kar	pg
kry	karamay	cn
krz	kiri	cd
ksa	kosrae	fm
ksb	kasanombe	pg
ksc	kosice	sk
ksd	karlstad	se
kse	kasese	ug
ksf	kassel	de
ksg	kisengan	pg
ksh	kermanshah	ir
ksi	kissidougou	gn
ksj	kasos island	gr
ksk	karlskoga	se
ksl	kassala	sd
ksm	saint marys	us
ksn	kostanay	kz
kso	kastoria	gr
ksp	kosipe	pg
ksq	karshi	uz
ksr	sandy river	us
kss	sikasso	ml
kst	kosti	sd
ksv	springvale	au
ksw	kiryat shmona	il
ksx	yasuru	pg
ksy	kars	tr
ksz	kotlas	ru
kta	karratha	au
ktb	thorne bay	us
ktc	katiola	ci
ktd	kitadaito	jp
kte	kerteh	my
ktf	takaka	nz
ktg	ketapang	id
kth	tikchik	us
kti	kratie	kh
ktk	kanua	pg
ktl	kitale	ke
ktm	kathmandu	np
ktn	ketchikan	us
kto	kato	gy
ktq	kitee	fi
ktr	katherine	au
kts	teller mission	us
ktt	kittila	fi
ktu	kota	in
ktv	kamarata	ve
ktw	katowice	pl
ktx	koutiala	ml
kty	katukurunda	lk
kua	kuantan	my
kuc	kuria	ki
kud	kudat	my
kue	kukundu	sb
kuf	samara	ru
kug	kubin island	au
kuh	kushiro	jp
kui	kawau island	nz
kuj	kushimoto	jp
kuk	kasigluk	us
kul	kuala lumpur	my
kum	yakushima	jp
kun	kaunas	lt
kuo	kuopio	fi
kup	kupiano	pg
kuq	kuri	pg
kur	kuran-o-munjan	af
kus	kulusuk	gl
kut	kutaisi	ge
kuu	bhuntar kullu	in
kuv	gunsan	kr
kuw	kugururok river	us
kux	kuyol	pg
kuy	kamusi	pg
kuz	gunsan ab	kr
kva	kavala	gr
kvb	skovde	se
kvc	king cove	us
kvd	gyandzha	az
kve	kitava	pg
kvg	kavieng	pg
kvk	kirovsk	ru
kvl	kivalina	us
kvr	kavalerovo	ru
kvu	korolevu	fj
kvx	kirov	ru
kwa	kwajalein	mh
kwb	karimunjawa	id
kwd	kawadjia	cf
kwe	guiyang	cn
kwf	waterfall	us
kwg	krivoy rog	ua
kwh	khwahan	af
kwi	kuwait city	kw
kwj	gwangju	kr
kwk	kwigillingok	us
kwl	guilin	cn
kwm	kowanyama	au
kwn	quinhagak	us
kwo	kawito	pg
kwp	west point	us
kwr	kwai harbour	sb
kws	kwailabesi	sb
kwt	kwethluk	us
kwu	mansion house	nz
kwv	kurwina	pg
kwx	kiwai island	pg
kwy	kiwayu	ke
kwz	kolwezi	cd
kxa	kasaan	us
kxe	klerksdorp	za
kxf	koro island	fj
kxk	komsomolsk na amure	ru
kxr	karoola	pg
kxu	katiu	pf
kya	konya	tr
kyd	orchid island	tw
kye	tripoli	lb
kyf	yeelirrie	au
kyi	yalata mission	au
kyk	karluk	us
kyl	key largo	us
kyn	milton keynes	gb
kyp	kyaukpyu	mm
kys	kayes	ml
kyt	kyauktaw	mm
kyu	koyukuk	us
kyx	yalumet	pg
kyz	kyzyl	ru
kzb	zachar bay	us
kzc	kompong-chhna	kh
kzd	krakor	kh
kzf	kaintiba	pg
kzg	kitzingen	de
kzh	kizhuyak	us
kzi	kozani	gr
kzn	kazan	ru
kzo	kzyl-orda	kz
kzr	kutahya	tr
kzs	kastelorizo	gr
laa	lamar	us
lab	lablab	pg
lac	pulau layang-layang island	my
lad	luanda	ao
lae	lae	pg
laf	lafayette	us
lag	la guaira	ve
lah	labuha	id
lai	lannion	fr
laj	lages	br
lak	aklavik	ca
lal	lakeland	us
lam	los alamos	us
lan	lansing	us
lao	laoag	ph
lap	la paz	mx
laq	beida	ly
lar	laramie	us
las	las vegas	us
lat	la uribe	co
lau	lamu	ke
lav	lalomalava	ws
law	lawton	us
lax	los angeles	us
lay	ladysmith	za
laz	bom jesus da lapa	br
lba	leeds	gb
lbb	lubbock	us
lbd	khudzhand	tj
lbe	latrobe	us
lbf	north platte	us
lbi	albi	fr
lbj	labuan bajo	id
lbk	liboi	ke
lbl	liberal	us
lbm	luabo	mz
lbn	lake baringo	ke
lbo	lusambo	cd
lbp	long banga	my
lbq	lambarene	ga
lbr	labrea	br
lbs	labasa	fj
lbt	lumberton	us
lbu	labuan	my
lbv	libreville	ga
lbw	long bawan	id
lbx	lubang	ph
lby	la baule-escoublac	fr
lbz	lukapa	ao
lca	larnaca	cy
lcb	pontes e lacerda	br
lcc	lecce	it
lcd	louis trichardt	za
lce	la ceiba	hn
lcf	rio dulce	gt
lcg	la coruna	es
lch	lake charles	us
lci	laconia	us
lcj	lodz	pl
lcl	la coloma	cu
lcm	la cumbre	ar
lcn	balcanoona	au
lco	lague	cg
lcp	loncopue	ar
lcq	lake city	us
lcr	la chorrera	co
lcs	las canas	cr
lcv	lucca	it
lcx	longyan	cn
lda	malda	in
ldb	londrina	br
ldc	lindeman island	au
lde	lourdes	fr
ldg	leshukonskoye	ru
ldh	lord howe island	au
ldi	lindi	tz
ldj	linden	us
ldk	lidkoping	se
ldm	ludington	us
ldn	lamidanda	np
ldo	ladouanie	sr
ldr	lodar	ye
lds	yichun	cn
ldu	lahad datu	my
ldv	landivisiau	fr
ldw	lansdowne	au
ldx	st laurent du maroni	gf
ldy	derry	gb
ldz	londolozi	za
lea	learmonth	au
leb	white river	us
lec	lencois	br
led	saint petersburg	ru
lee	leesburg	us
lef	lebakeng	ls
leg	aleg	mr
leh	le havre	fr
lei	almeria	es
lej	leipzig-halle	de
lek	labe	gn
lel	lake evella	au
lem	lemmon	us
len	leon	es
leo	leconi	ga
lep	leopoldina	br
leq	lands end	gb
ler	leinster	au
les	lesobeng	ls
let	leticia	co
leu	seo de urgel	es
lev	bureta	fj
lew	lewiston	us
lex	lexington	us
ley	lelystad	nl
lez	la esperanza	hn
lfb	lumbo	mz
lfm	lamerd	ir
lfn	louisburg	us
lfo	kelafo	et
lfp	lakefield	au
lfr	la fria	ve
lft	lafayette	us
lfw	lome	tg
lgb	long beach	us
lgc	la grange	us
lgd	la grande	us
lge	lake gregory	au
lgg	liege	be
lgh	leigh creek	au
lgi	long island	bs
lgj	lugoj	ro
lgk	langkawi	my
lgl	long lellang	my
lgm	laiagam	pg
lgn	linga linga	pg
lgo	langeoog	de
lgp	legazpi	ph
lgq	lago agrio	ec
lgr	cochrane	cl
lgs	malargue	ar
lgt	las gaviotas	co
lgu	logan	us
lgx	lugh ganane	so
lgy	lagunillas	ve
lgz	leguizamo	co
lha	lahr	de
lhb	lost harbor	us
lhe	lahore	pk
lhg	lightning ridge	au
lhi	lereh	id
lhk	guanghua	cn
lhn	lishan	tw
lhp	lehu	pg
lhs	las heras	ar
lhu	caprivi	na
lhv	lock haven	us
lhw	lanzhou	cn
lia	liangping	cn
lib	limbunya	au
lic	limon	us
lie	libenge	cd
lif	lifou	nc
lig	limoges	fr
lih	lihue	us
lii	mulia	id
lij	long island	us
lik	likiep island	mh
lil	lille	fr
lim	lima	pe
lio	limon	cr
lip	lins	br
liq	lisala	cd
lir	liberia	cr
lis	lisbon	pt
lit	little rock	us
liv	livengood	us
liw	loikaw	mm
lix	likoma island	mw
liy	hinesville	us
liz	limestone	us
lja	lodja	cd
ljg	lijiang city	cn
ljn	lake jackson	us
lju	ljubljana	si
lka	larantuka	id
lkb	lakeba	fj
lkc	lekana	cg
lkd	lakeland downs	au
lkg	lokichoggio	ke
lkh	long akah	my
lkk	kulik lake	us
lkl	lakselv	no
lkn	leknes	no
lko	lucknow	in
lkp	lake placid	us
lkr	las khoreh	so
lks	lakeside	us
lku	lake rudolf	ke
lkv	lakeview	us
lkw	lekhwair	om
lky	lake manyara	tz
lkz	brandon	gb
lla	lulea	se
llb	libo	cn
lle	malelane	za
llf	lingling	cn
llg	chillagoe	au
llh	las limas	hn
lli	lalibela	et
llk	lankaran	az
lll	lissadell	au
llm	long lama	my
lln	kelila	id
llp	linda downs	au
lls	las lomitas	ar
llt	lobito	ao
llu	alluitsup paa	gl
llw	lilongwe	mw
llx	lyndonville	us
lly	mount holly	us
lma	lake minchumina	us
lmb	salima	mw
lmc	lamacarena	co
lmd	los menucos	ar
lme	le mans	fr
lmg	lamassa	pg
lmh	limon	hn
lmi	lumi	pg
lml	lae island	mh
lmm	los mochis	mx
lmn	limbang	my
lmo	lossiemouth	gb
lmp	lampedusa	it
lmq	marsa brega	ly
lmr	lime acres	za
lms	louisville	us
lmt	klamath falls	us
lmx	lopez de micay	co
lmy	lake murray	pg
lmz	palma	mz
lnb	lamen bay	vu
lnc	lengbati	pg
lnd	lander	us
lne	lonorore	vu
lnf	munbil	pg
lng	lese	pg
lnh	lake nash	au
lni	lonely	us
lnj	lincang	cn
lnk	lincoln	us
lnm	langimar	pg
lnn	willoughby	us
lno	leonora	au
lnp	wise	us
lnq	loani	pg
lnr	lone rock	us
lns	lancaster	us
lnv	lihir island	pg
lnx	smolensk	ru
lny	lanai city	us
lnz	linz	at
loa	lorraine	au
lob	los andes	cl
loc	lock	au
lod	longana	vu
loe	loei	th
lof	loen	mh
log	longview	us
loh	catamayo	ec
loi	lontras	br
lok	lodwar	ke
lol	lovelock	us
lom	lagos de moreno	mx
lon	london	gb
loo	laghouat	dz
lop	praya	id
loq	lobatse	bw
los	lagos	ng
lot	lockport	us
lov	monclova	mx
low	louisa	us
lox	los tablones	gt
loy	loyangalani	ke
loz	london	us
lpa	las palmas	es
lpb	la paz	bo
lpc	lompoc	us
lpd	la pedrera	co
lpe	la primavera	co
lpg	la plata	ar
lpi	linkoping	se
lpj	pijiguaos	ve
lpk	lipetsk	ru
lpl	liverpool	gb
lpm	lamap	vu
lpn	leron plains	pg
lpo	laporte	us
lpp	lappeenranta	fi
lpq	luang prabang	la
lps	lopez island	us
lpt	lampang	th
lpu	long apung	id
lpw	little port walter	us
lpx	liepaja	lv
lpy	le puy	fr
lqk	pickens	us
lqm	puerto leguizamo	co
lqn	qala nau	af
lqs	lingshui	cn
lra	larisa	gr
lrb	leribe	ls
lrd	laredo	us
lre	longreach	au
lrf	jacksonville	us
lrg	lora lai	pk
lrh	la rochelle	fr
lri	lorica	co
lrj	lemars	us
lrk	lincoln rock	us
lrl	niamtougou	tg
lrm	la romana	do
lro	lathrop	us
lrq	laurie river	ca
lrr	lar	ir
lrs	leros	gr
lrt	lorient	fr
lru	las cruces	us
lrv	los roques	ve
lsa	losuia	pg
lsb	lordsburg	us
lsc	la serena	cl
lse	la crosse	us
lsf	fort benning	us
lsh	lashio	mm
lsj	long island	pg
lsk	lusk	us
lsl	los chiles	cr
lsm	long semado	my
lsn	los banos	us
lso	les sables	fr
lsp	las piedras	ve
lsq	los angeles	cl
lsr	lost river	us
lss	terre-de-haut	gp
lst	launceston	au
lsu	long sukang	my
lsw	lhoksumawe	id
lsx	lhok sukon	id
lsy	lismore	au
lsz	mali losinj	hr
lta	tzaneen	za
ltb	latrobe	au
ltc	lai	td
ltd	ghadames	ly
ltf	leitre	pg
ltg	langtang	np
lth	lathrop wells	us
lti	altai	mn
ltk	latakia	sy
ltl	lastourville	ga
ltm	lethem	gy
lto	loreto	mx
ltp	lyndhurst	au
ltq	le touquet	fr
ltr	letterkenny	ie
lts	altus	us
ltt	saint tropez	fr
ltu	latur	in
ltv	lotusvale	au
ltw	leonardtown	us
ltx	latacunga	ec
lua	lukla	np
lub	lumid pau	gy
luc	laucala island	fj
lud	luderitz	na
lue	lucenec	sk
lug	lugano	ch
luh	ludhiana	in
lui	la union	hn
lul	laurel	us
lum	mangshi	cn
lun	lusaka	zm
luo	luena	ao
lup	kalaupapa	us
luq	san luis	ar
lur	cape lisburne	us
lus	lusanga	cd
lut	laura station	au
luu	laura	au
luv	langgur	id
luw	luwuk	id
lux	luxembourg	lu
luz	lushan	pl
lva	laval	fr
lvb	livramento	br
lvd	lime village	us
lvi	livingstone	zm
lvk	livermore	us
lvl	lawrenceville	us
lvm	livingston	us
lvo	laverton	au
lvp	lavan	ir
lvr	lucas do rio verde	br
lvs	las vegas	us
lwa	lwbak	ph
lwb	lewisburg	us
lwc	lawrence	us
lwe	lewoleba	id
lwh	lawn hill	au
lwi	lowai	pg
lwl	wells	us
lwm	lawrence	us
lwn	gyoumri	am
lwo	lviv	ua
lwr	leeuwarden	nl
lws	lewiston	us
lwt	lewistown	us
lwv	lawrenceville	us
lwy	lawas	my
lxa	gonggar	cn
lxg	luang namtha	la
lxn	lexington	us
lxr	luxor	eg
lxs	limnos	gr
lxu	lukulu	zm
lxv	leadville	us
lya	luoyang	cn
lyb	little cayman	ky
lyc	lycksele	se
lye	lyneham	gb
lyg	lianyungang	cn
lyh	lynchburg	us
lyi	linyi	cn
lyk	lunyuk	id
lyo	lyons	us
lyp	faisalabad	pk
lyr	longyearbyen	sj
lys	lyon	fr
lyt	lady elliot island	au
lyu	ely	us
lyx	lydd	gb
lza	luiza	cd
lzc	lazaro cardenas	mx
lzh	liuzhou	cn
lzi	luozi	cd
lzm	luzamba	ao
lzn	nangan	tw
lzo	luzhou	cn
lzr	lizard island	au
lzu	lawrenceville	us
lzy	lin zhi	cn
maa	chennai	in
mab	maraba	br
mad	madrid	es
mae	madera	us
maf	midland	us
mag	madang	pg
mah	menorca	es
mai	mangochi	mw
maj	majuro	mh
mak	malakal	ss
mal	mangole	id
mam	matamoros	mx
man	manchester	gb
mao	manaus	br
map	mamai	pg
maq	mae sot	th
mar	maracaibo	ve
mas	manus island	pg
mat	matadi	cd
mau	maupiti	pf
mav	maloelap island	mh
maw	malden	us
max	matam	sn
may	mangrove cay	bs
maz	mayaguez	pr
mba	mombasa	ke
mbb	marble bar	au
mbc	mbigou	ga
mbd	mmabatho	za
mbe	monbetsu	jp
mbf	mount buffalo	au
mbg	mobridge	us
mbh	maryborough	au
mbi	mbeya	tz
mbj	montego bay	jm
mbk	matupa	br
mbl	manistee	us
mbm	mkambati	za
mbn	mount barnett	au
mbo	mamburao	ph
mbp	moyobamba	pe
mbq	mbarara	ug
mbr	mbout	mr
mbs	saginaw	us
mbt	masbate	ph
mbu	mbambanakira	sb
mbv	masa	pg
mbx	maribor	si
mby	moberly	us
mbz	maues	br
mca	macenta	gn
mcb	mccomb	us
mcd	mackinac island	us
mce	merced	us
mcg	mcgrath	us
mch	machala	ec
mcj	maicao	co
mck	mccook	us
mcl	mount mckinley	us
mcm	monte carlo	mc
mcn	macon	us
mcp	macapa	br
mcq	miskolc	hu
mcr	melchor de menco	gt
mcs	monte caseros	ar
mct	muscat	om
mcu	montlucon	fr
mcv	mcarthur river	au
mcw	mason city	us
mcx	makhachkala	ru
mcy	sunshine coast	au
mcz	maceio	br
mdb	melinda	bz
mdc	manado	id
mde	medellin	co
mdf	medford	us
mdg	mudanjiang	cn
mdh	carbondale	us
mdi	makurdi	ng
mdj	madras	us
mdk	mbandaka	cd
mdl	mandalay	mm
mdm	munduku	pg
mdn	madison	us
mdo	middleton island	us
mdp	mindiptana	id
mdq	mar del plata	ar
mdr	medfra	us
mds	middle caicos	tc
mdu	mendi	pg
mdv	medouneu	ga
mdx	mercedes	ar
mdy	midway island	um
mdz	mendoza	ar
mea	macae	br
mec	manta	ec
med	madinah	sa
mee	mare	nc
mef	melfi	td
meg	melanje	ao
meh	mehamn	no
mei	meridian	us
mej	meadville	us
mek	meknes	ma
mel	melbourne	au
mem	memphis	us
men	mende	fr
meo	manteo	us
mep	mersing	my
meq	meulaboh	id
mes	medan	id
met	moreton	au
meu	monte dourado	br
mev	minden	us
mew	mweka	cd
mex	mexico city	mx
mey	meghauli	np
mez	messina	za
mfa	mafia	tz
mfb	monfort	co
mfc	mafeteng	ls
mfd	mansfield	us
mfe	mc allen	us
mff	moanda	ga
mfg	muzaffarabad	pk
mfh	mesquite	us
mfi	marshfield	us
mfj	moala	fj
mfk	matsu	tw
mfl	mount full stop	au
mfm	macau	mo
mfn	milford sound	nz
mfo	manguna	pg
mfp	manners creek	au
mfq	maradi	ne
mfr	medford	us
mfs	miraflores	co
mft	machu picchu	pe
mfu	mfuwe	zm
mfv	melfa	us
mfw	magaruque	mz
mfx	meribel	fr
mfy	mayfa'ah	ye
mfz	mesalia	pg
mga	managua	ni
mgb	mount gambier	au
mgc	michigan city	us
mgd	magdalena	bo
mge	marietta	us
mgf	maringa	br
mgg	margarima	pg
mgh	margate	za
mgi	matagorda island	us
mgj	montgomery	us
mgk	mong ton	mm
mgm	montgomery	us
mgn	magangue	co
mgo	manega	ga
mgp	manga	pg
mgq	mogadishu	so
mgr	moultrie	us
mgs	mangaia island	ck
mgt	milingimbi	au
mgu	manaung	mm
mgv	margaret river station	au
mgw	morgantown	us
mgx	moabi	ga
mgz	myeik	mm
mha	mahdia	gy
mhd	mashad	ir
mhe	mitchell	us
mhf	morichal	co
mhg	mannheim	de
mhh	marsh harbour	bs
mhi	musha	dj
mhk	manhattan	us
mhl	marshall	us
mhm	minchumina	us
mhn	mullen	us
mho	mount house	au
mhq	mariehamn	ax
mhs	mount shasta	us
mht	manchester	us
mhu	mount hotham	au
mhv	mojave	us
mhw	monteagudo	bo
mhx	manihiki island	ck
mhy	morehead	pg
mhz	mildenhall	gb
mia	miami	us
mid	merida	mx
mie	muncie	us
mif	monahans	us
mig	mian yang	cn
mih	mitchell plateau	au
mii	marilia	br
mij	mili island	mh
mik	mikkeli	fi
mil	milan	it
mim	merimbula	au
min	minnipa	au
mio	miami	us
mip	mitspeh ramon	il
mir	monastir	tn
mis	misima island	pg
mit	shafter	us
miu	maiduguri	ng
miv	millville	us
miw	marshalltown	us
mix	miriti	co
miy	mittiebah	au
miz	mainoru	au
mja	manja	mg
mjb	mejit island	mh
mjc	man	ci
mjd	mohenjodaro	pk
mje	majkin	mh
mjf	mosjoen	no
mjg	mayajigua	cu
mjj	moki	pg
mjk	monkey mia	au
mjl	mouila	ga
mjm	mbuji-mayi	cd
mjn	majunga	mg
mjo	mount etjo lodge	na
mjp	manjimup	au
mjq	jackson	us
mjr	miramar	ar
mjs	maganja da costa	mz
mjt	mytilene	gr
mju	mamuju	id
mjv	murcia	es
mjw	mahenye	zw
mjx	toms river	us
mjy	mangunjaya	id
mjz	mirnyj	ru
mka	marianske lazne	cz
mkb	mekambo	ga
mkc	kansas city	us
mke	milwaukee	us
mkg	muskegon	us
mkh	mokhotlong	ls
mki	obo	cf
mkj	makoua	cg
mkk	hoolehua	us
mkl	jackson	us
mkm	mukah	my
mkn	malekolon	pg
mko	muskogee	us
mkp	makemo	pf
mkq	merauke	id
mkr	meekatharra	au
mks	mekane selam	et
mkt	mankato	us
mku	makokou	ga
mkv	mount cavenagh	au
mkw	manokwari	id
mky	mackay	au
mkz	malacca	my
mla	gudja	mt
mlb	melbourne	us
mlc	mc alester	us
mld	malad city	us
mle	male	mv
mlf	milford	us
mlg	malang	id
mli	moline	us
mlj	milledgeville	us
mlk	malta	us
mll	marshall	us
mlm	morelia	mx
mln	melilla	es
mlo	milos	gr
mlp	malabang	ph
mlq	malalaua	pg
mlr	millicent	au
mls	miles city	us
mlt	millinocket	us
mlu	monroe	us
mlv	merluna	au
mlw	monrovia	lr
mlx	malatya	tr
mly	manley hot springs	us
mlz	melo	uy
mma	malmo	se
mmb	memanbetsu	jp
mmc	mante	mx
mmd	minami daito	jp
mme	teesside	gb
mmf	mamfe	cm
mmg	mount magnet	au
mmh	mammoth lakes	us
mmi	athens	us
mmj	matsumoto	jp
mmk	murmansk	ru
mml	marshall	us
mmm	middlemount	au
mmn	stow	us
mmo	maio	cv
mmp	mompos	co
mmq	mbala	zm
mms	marks	us
mmu	morristown	us
mmv	mal	pg
mmw	moma	mz
mmy	miyako jima	jp
mmz	maimana	af
mna	melangguane	id
mnb	moanda	cd
mnc	nacala	mz
mnd	medina	co
mne	mungeranie	au
mnf	mana island	fj
mng	maningrida	au
mnh	minneriya	lk
mni	gerald's park	ms
mnj	mananjary	mg
mnk	maiana	ki
mnl	manila	ph
mnm	menominee	us
mnn	marion	us
mno	manono	cd
mnp	maron	pg
mnq	monto	au
mnr	mongu	zm
mns	mansa	zm
mnt	minto	us
mnu	maulmyine	mm
mnv	mountain valley	au
mnw	macdonald downs	au
mnx	manicore	br
mny	mono	sb
mnz	manassas	us
moa	moa	cu
mob	mobile	us
moc	montes claros	br
mod	modesto	us
moe	momeik	mm
mof	maumere	id
mog	mong hsat	mm
moi	mitiaro island	ck
moj	moengo	sr
mol	molde	no
mom	moudjeria	mr
mon	mount cook	nz
moo	moomba	au
mop	mount pleasant	us
moq	morondava	mg
mor	morristown	us
mos	moses point	us
mot	minot	us
mou	mountain village	us
mov	moranbah	au
mow	moscow	ru
mox	morris	us
moy	monterrey	co
moz	moorea	pf
mpa	mpacha	na
mpc	muko-muko	id
mpd	mirpur khas	pk
mpe	madison	us
mpf	mapoda	pg
mpg	makini	pg
mph	caticlan	ph
mpi	mamitupo	pa
mpj	morrilton	us
mpk	mokpo	kr
mpl	montpellier	fr
mpm	maputo	mz
mpn	mount pleasant	fk
mpo	mount pocono	us
mpp	mulatupo	pa
mpq	maan	jo
mpr	mcpherson	us
mps	mount pleasant	us
mpt	maliana	tl
mpu	mapua	pg
mpv	montpelier	us
mpw	mariupol	ua
mpx	miyanmin	pg
mpy	maripasoula	gf
mpz	mount pleasant	us
mqa	mandora	au
mqb	macomb	us
mqc	miquelon	pm
mqd	maquinchao	ar
mqe	marqua	au
mqf	magnitogorsk	ru
mqg	midgard	na
mqh	minacu	br
mqi	quincy	us
mqk	san matias	bo
mql	mildura	au
mqm	mardin	tr
mqn	mo i rana	no
mqo	malam	pg
mqq	moundou	td
mqr	mosquera	co
mqs	mustique island	vc
mqt	marquette	us
mqu	mariquita	co
mqv	mostaganem	dz
mqw	mc rae	us
mqx	makale	et
mqy	smyrna	us
mqz	margaret river	au
mra	misurata	ly
mrb	martinsburg	us
mrc	columbia	us
mrd	merida	ve
mre	mara lodges	ke
mrf	marfa	us
mrg	mareeba	au
mrh	may river	pg
mrj	marcala	hn
mrk	marco island	us
mrl	miners lake	au
mrm	manare	pg
mrn	morganton	us
mro	masterton	nz
mrp	marla	au
mrq	marinduque	ph
mrr	macara	ec
mrs	marseille	fr
mrt	moroak	au
mru	plaisance	mu
mrv	mineralnye vody	ru
mrw	maribo	dk
mrx	bandar mahshahr	ir
mry	monterey	us
mrz	moree	au
msa	muskrat dam	ca
msc	mesa	us
msd	mount pleasant	us
mse	manston	gb
msf	mount swan	au
msg	matsaile	ls
msh	masirah	om
msi	masalembo	id
msj	misawa	jp
msk	mastic point	bs
msl	sheffield	us
msm	masi manimba	cd
msn	madison	us
mso	missoula	us
msp	minneapolis	us
msq	minsk	by
msr	mus	tr
mss	massena	us
mst	maastricht	nl
msu	maseru	ls
msv	monticello	us
msw	massawa	er
msx	mossendjo	cg
msy	new orleans	us
msz	namibe	ao
mta	matamata	nz
mtb	monte libano	co
mtc	mt clemens	us
mtd	mount sandford	au
mte	monte alegre	br
mtf	mizan teferi	et
mtg	mato grosso	br
mth	marathon	us
mti	mosteiros	cv
mtj	montrose	us
mtk	makin island	ki
mtl	maitland	au
mtm	metlakatla	us
mto	mattoon	us
mtp	montauk	us
mtq	mitchell	au
mtr	monteria	co
mts	manzini	sz
mtt	minatitlan	mx
mtu	montepuez	mz
mtv	mota lava	vu
mtw	manitowoc	us
mty	monterrey	mx
mtz	masada	il
mua	munda	sb
mub	maun	bw
muc	munich	de
mud	mueda	mz
mue	kamuela	us
muf	muting	id
mug	mulege	mx
muh	mersa matruh	eg
mui	fort indiantown	us
muj	mui	et
muk	mauke island	ck
mun	maturin	ve
muo	mountain home	us
mup	mulga park	au
muq	muccan	au
mur	marudi	my
mus	marcus island	jp
mut	muscatine	us
muu	mount union	us
muw	mascara-ghriss	dz
mux	multan	pk
muy	mouyondzi	cg
muz	musoma	tz
mva	myvatn	is
mvb	franceville	ga
mvc	monroeville	us
mvd	montevideo	uy
mve	montevideo	us
mvf	mossoro	br
mvg	mevang	ga
mvh	macksville	au
mvi	manetai	pg
mvj	mandeville	jm
mvk	mulka	au
mvl	stowe	us
mvm	kayenta	us
mvn	mount vernon	us
mvo	mongo	td
mvp	mitu	co
mvq	mogilev	by
mvr	maroua	cm
mvs	mucuri	br
mvt	mataiva	pf
mvu	musgrave	au
mvv	megeve	fr
mvw	mount vernon	us
mvx	minvoul	ga
mvy	vineyard haven	us
mvz	masvingo	zw
mwa	marion	us
mwb	morawa	au
mwd	mianwali	pk
mwe	merowe	sd
mwf	maewo	vu
mwg	marawaka	pg
mwh	moses lake	us
mwi	maramuni	pg
mwj	matthews ridge	gy
mwk	matak	id
mwl	mineral wells	us
mwm	windom	us
mwn	mwadui	tz
mwo	middletown	us
mwp	mountain	np
mwq	magwe	mm
mwr	motswari	za
mws	mount wilson	us
mwt	moolawatana	au
mwu	mussau	pg
mwv	mundulkiri	kh
mwx	muan	kr
mwy	miranda downs	au
mwz	mwanza	tz
mxa	manila	us
mxb	masamba	id
mxc	monticello	us
mxd	marion downs	au
mxe	maxton	us
mxg	marlborough	us
mxh	moro	pg
mxi	mati	ph
mxj	minna	ng
mxk	mindik	pg
mxl	mexicali	mx
mxm	morombe	mg
mxn	morlaix	fr
mxo	monticello	us
mxr	mirgorod	ua
mxs	maota savaii island	ws
mxt	maintirano	mg
mxu	mullewa	au
mxv	moron	mn
mxw	mandalgobi	mn
mxx	mora	se
mxy	mccarthy	us
mxz	meixian	cn
mya	moruya	au
myb	mayoumba	ga
myc	maracay	ve
myd	malindi	ke
mye	miyake jima	jp
myg	mayaguana	bs
myh	marble canyon	us
myi	murray island	au
myj	matsuyama	jp
myk	may creek	us
myl	mccall	us
mym	monkey mountain	gy
myn	mareb	ye
myo	myroodah	au
myp	mary	tm
myq	mysore	in
myr	myrtle beach	us
myt	myitkyina	mm
myu	mekoryuk	us
myv	marysville	us
myw	mtwara	tz
myx	menyamya	pg
myy	miri	my
myz	monkey bay	mw
mzb	mocimboa praia	mz
mzc	mitzic	ga
mzd	mendez	ec
mze	manatee	bz
mzf	mzamba(wild coast sun)	za
mzg	makung	tw
mzh	merzifon	tr
mzi	mopti	ml
mzj	marana	us
mzk	marakei	ki
mzl	manizales	co
mzn	minj	pg
mzo	manzanillo	cu
mzp	motueka	nz
mzq	mkuze	za
mzr	mazar-i-sharif	af
mzs	mostyn	my
mzt	mazatlan	mx
mzu	muzaffarpur	in
mzv	mulu	my
mzw	mechria	dz
mzx	mena	et
mzy	mossel bay	za
mzz	marion	us
naa	narrabri	au
nac	naracoorte	au
nad	macanal	co
nae	natitingou	bj
naf	banaina	id
nag	nagpur	in
nah	naha	id
nai	annai	gy
naj	nakhichevan	az
nak	nakhon ratchasima	th
nal	nalchik	ru
nam	namlea	id
nan	nadi	fj
nao	nanchong	cn
nap	napoli	it
naq	qaanaaq	gl
nar	nare	co
nas	nassau	bs
nat	natal	br
nau	napuka island	pf
nav	nevsehir	tr
naw	narathiwat	th
nax	kapolei	us
naz	star habour	sb
nba	nambaiyufa	pg
nbb	barrancominas	co
nbc	naberevnye chelny	ru
nbe	enfidha	tn
nbh	nambucca heads	au
nbl	san blas	pa
nbo	nairobi	ke
nbs	baishan	cn
nbu	glenview	us
nbv	cana brava	br
nbx	nabire	id
nca	north caicos	tc
nce	nice	fr
ncg	paloma grande	mx
nch	nachingwea	tz
nci	necocli	co
ncj	sunchales	ar
ncl	newcastle	gb
ncn	new chenega	us
nco	quonset point	us
ncp	luzon island	ph
ncr	san carlos	ni
ncs	newcastle	za
nct	nicoya	cr
ncu	nukus	uz
ncy	annecy	fr
nda	bandanaira	id
ndb	nouadhibou	mr
ndc	nanded	in
ndd	sumbe	ao
nde	mandera	ke
ndf	ndalatandos	ao
ndg	qiqihar	cn
ndi	namudi	pg
ndj	n'djamena	td
ndk	namdrik island	mh
ndl	ndele	cf
ndm	mendi	et
ndn	nadunumu	pg
ndo	la palma del condado	es
ndr	nador	ma
nds	sandstone	au
ndu	rundu	na
ndv	anacostia	us
ndy	sanday	gb
nea	glynco	us
nec	necochea	ar
nef	neftekamsk	ru
neg	negril	jm
nej	nejjo	et
nek	nekemt	et
nel	lakehurst	us
nen	whitehouse	us
ner	neryungri	ru
net	new bight	bs
neu	sam neua	la
nev	nevis	kn
nfg	nefteyugansk	ru
nfl	fallon	us
nfo	niuafo'ou	to
nfr	nafoora	ly
nga	young	au
ngb	ningbo	cn
ngd	anegada	vg
nge	ngaoundéré	cm
ngi	ngau island	fj
ngk	nogliki	ru
ngl	ngala	za
ngn	nargana	pa
ngo	nagoya	jp
ngq	shiquanhe	cn
ngr	ningerum	pg
ngs	nagasaki	jp
ngx	manang	np
ngz	alameda	us
nha	nha trang	vn
nhf	new halfa	sd
nhk	patuxent river	us
nhs	nushki	pk
nht	northolt	gb
nhv	nuku hiva	pf
nhx	foley	us
nhz	brunswick	us
nia	nimba	lr
nib	nikolai	us
nic	nicosia	cy
nie	niblack	us
nif	nifty	au
nig	nikunau	ki
nik	niokolo koba	sn
nim	niamey	ne
nin	ninilchik	us
nio	nioki	cd
nir	beeville	us
nis	simberi island	pg
nit	niort	fr
niu	niau	pf
nix	nioro	ml
nja	atsugi	jp
njc	nizhnevartovsk	ru
njf	al najaf	iq
nka	nkan	ga
nkb	noonkanbah	au
nkc	nouakchott	mr
nkd	sinak	id
nkg	nanjing	cn
nki	naukiti	us
nkl	nkolo	cd
nkn	nankina	pg
nko	ankokoambo	mg
nks	nkongsamba	cm
nku	nkaus	ls
nkv	nichen cove	us
nky	nkayi	cg
nla	ndola	zm
nlc	lemoore	us
nld	nuevo laredo	mx
nle	niles	us
nlf	darnley island	au
nlg	nelson lagoon	us
nlk	norfolk island	nf
nll	nullagine	au
nln	kneeland	us
nlp	nelspruit	za
nls	nicholson	au
nlt	xinyuan	cn
nlv	nikolaev	ua
nma	namangan	uz
nmb	daman	in
nmc	norman's cay	bs
nme	nightmute	us
nmg	san miguel	pa
nml	mildred lake	ca
nmn	nomane	pg
nmp	new moon	au
nmr	nappa merry	au
nms	namsang	mm
nmt	namtu	mm
nmu	namu	mh
nna	kenitra	ma
nnb	santa ana	sb
nnd	nangade	mz
nng	nanning	cn
nni	namutoni	na
nnk	naknek	us
nnl	nondalton	us
nnm	naryan-mar	ru
nnr	spiddal	ie
nnt	nan	th
nnu	nanuque	br
nnx	nunukan	id
nny	nanyang	cn
noa	nowra	au
nob	nosara beach	cr
noc	knock	ie
nod	norden	de
nog	nogales	mx
noi	novorossijsk	ru
noj	nojabrxsk	ru
nok	nova xavantina	br
nol	nakolik river	us
nom	nomad river	pg
non	rotima	ki
noo	naoro	pg
nop	sinop	tr
nor	nordfjordur	is
nos	nossi-be	mg
not	novato	us
nou	noumea	nc
nov	huambo	ao
noz	novokuznetsk	ru
npe	napier	nz
npg	nipa	pg
nph	nephi	us
npl	new plymouth	nz
npo	nangapinoh	id
npp	napperby	au
npr	novo progresso	br
npt	newport	us
npu	san pedro uraba	co
nqi	kingsville	us
nql	niquelandia	br
nqn	neuquen	ar
nqt	nottingham	gb
nqu	nuqui	co
nqy	newquay	gb
nra	narrandera	au
nrb	mayport	us
nrc	crows landing	us
nrd	norderney	de
nre	namrole	id
nrg	narrogin	au
nri	shangri-la	us
nrk	norrkoping	se
nrl	north ronaldsay	gb
nrm	nara	ml
nrr	roosevelt roads	pr
nrs	imperial beach	us
nry	newry	au
nse	milton	us
nsh	now shahr	ir
nsk	norilsk	ru
nsl	slayton	us
nsm	norseman	au
nsn	nelson	nz
nso	scone	au
nsp	sangley point	ph
nst	nakhon si thammarat	th
nsv	noosaville	au
nsx	nord sound	vg
nsy	sigonella	it
nsz	nansha	cn
nta	natadola	fj
ntb	notodden	no
ntc	santa carolina	mz
ntd	port hueneme	us
nte	nantes	fr
ntg	nantong	cn
nti	bintuni	id
ntj	manti	us
ntl	newcastle	au
ntm	miracema do norte	br
ntn	normanton	au
nto	santo antao	cv
ntq	wajima	jp
ntt	niuatoputapu	to
ntu	oceana	us
ntx	natuna ranai	id
nty	sun city	za
nua	nuwara eliya	lk
nub	numbulwar	au
nud	en nahud	sd
nue	nürnberg	de
nuf	hatton	lk
nug	nuguria	pg
nuh	nunchia	co
nui	nuiqsut	us
nuj	nojeh	ir
nuk	nukutavake	pf
nul	nulato	us
nup	nunapitchuk	us
nuq	mountain view	us
nur	nullarbor	au
nus	norsup	vu
nut	nutuve	pg
nuu	nakuru	ke
nuw	whidbey island	us
nux	novy urengoy	ru
nva	neiva	co
nvd	nevada	us
nvg	nueva guinea	ni
nvi	navoi	uz
nvk	narvik	no
nvn	beckwourth	us
nvp	novo aripuana	br
nvr	novgorod	ru
nvs	nevers	fr
nvt	navegantes	br
nvy	neyveli	in
nwa	moheli	km
nwh	newport	us
nwi	norwich	gb
nwp	argentia	ca
nwt	nowata	pg
nxx	willow grove	us
nya	nyagan	ru
nyc	new york	us
nye	nyeri	ke
nyg	quantico	us
nyi	sunyani	gh
nyk	nanyuki	ke
nym	nadym	ru
nyn	nyngan	au
nyt	nay pyi taw	mm
nyu	nyaung-u	mm
nza	nzagi	ao
nze	nzerekore	gn
nzh	manzhouli	cn
nzw	south weymouth	us
oaa	shank	af
oag	orange	au
oah	shindand	af
oai	bagram	af
oaj	jacksonville	us
oak	oakland	us
oal	cacoal	br
oam	oamaru	nz
oan	olanchito	hn
oas	sharana	af
oax	oaxaca	mx
oaz	camp bastion	af
oba	oban	au
obc	obock	dj
obd	obano	id
obe	okeechobee	us
obf	oberpfaffenhofen	de
obi	obidos	br
obk	northbrook	us
obl	zoersel	be
obm	morobe	pg
obn	oban	gb
obo	obihiro	jp
obs	aubenas	fr
obt	oakland	us
obu	kobuk	us
obx	obo	pg
oby	ittoqqortoormiit	gl
oca	ocean reef	us
occ	coca	ec
oce	ocean city	us
ocf	ocala	us
och	nacogdoches	us
oci	oceanic	us
ocj	ocho rios	jm
ocn	oceanside	us
ocv	ocana	co
ocw	washington	us
oda	ouadda	cf
odb	cordoba	es
odc	oakdale	us
odd	oodnadatta	au
ode	odense	dk
odh	odiham	gb
odj	ouanda djalle	cf
odl	cordillo downs	au
odn	long seridan	my
odo	bodaybo	ru
odr	ord river	au
ods	odessa	ua
odw	oak harbor	us
ody	oudomxay	la
oea	vincennes	us
oec	ocussi	tl
oel	orel	ru
oem	paloemeu	sr
oeo	osceola	us
oer	ornskoldsvik	se
oes	san antonio oeste	ar
ofi	ouango fitini	ci
ofj	olafsfjordur	is
ofk	norfolk	us
ofu	vaoto	as
oga	ogallala	us
ogb	orangeburg	us
ogd	ogden	us
oge	ogeranang	pg
ogg	maui	us
ogl	ogle	gy
ogm	ustupu island	pa
ogn	yonaguni jima	jp
ogo	abengourou	ci
ogr	bongor	td
ogs	ogdensburg	us
ogv	ongava game reserve	na
ogx	ouargla	dz
ogz	vladikavkaz	ru
oha	ohakea	nz
ohb	moramanga	mg
ohc	northeast cape	us
ohd	ohrid	mk
ohe	mohe	cn
ohh	okha	ru
ohi	oshakati	na
oho	okhotsk	ru
ohr	wyk auf foehr	de
oht	kohat	pk
oia	ourilandia	br
oic	norwich	us
oil	oil city	us
oim	oshima	jp
oir	okushiri	jp
oit	oita	jp
oka	okinawa	jp
okb	orchid beach	au
okc	oklahoma city	us
oke	okino erabu	jp
okf	okaukuejo	na
okg	okoyo	cg
okh	oakham	gb
oki	oki island	jp
okj	okayama	jp
okk	kokomo	us
okl	oksibil	id
okm	okmulgee	us
okn	okondja	ga
okp	oksapmin	pg
okq	okaba	id
okr	yorke island	au
oks	oshkosh	us
okt	oktiabrskij	ru
oku	mokuti lodge	na
okv	okao	pg
oky	oakey	au
ola	orland	no
olb	olbia	it
olc	sao paulo de olivenca	br
old	old town	us
ole	olean	us
olf	wolf point	us
olh	old harbor	us
oli	olafsvik	is
olj	olpoi	vu
olk	fuerte olimpo	py
oll	oyo	cg
olm	olympia	us
oln	colonia sarmiento	ar
olo	olomouc	cz
olp	olympic dam	au
olq	olsobip	pg
olr	salerno	af
ols	nogales	us
olu	columbus	us
olv	olive branch	us
oly	olney	us
oma	omaha	us
omb	omboue	ga
omc	ormoc	ph
omd	oranjemund	na
ome	nome	us
omf	mafraq	jo
omg	omega	na
omh	urmieh	ir
omi	omidieh	ir
omj	omura	jp
omk	omak	us
oml	omkalai	pg
omm	marmul	om
omo	mostar	ba
omr	oradea	ro
oms	omsk	ru
omy	oddor meanche	kh
ona	winona	us
onb	ononge	pg
ond	ondangwa	na
one	onepusu	sb
ong	mornington	au
onh	oneonta	us
oni	moanamani	id
onj	odate noshiro	jp
onl	oneill	us
onm	socorro	us
onn	onion bay	us
ono	ontario	us
onp	newport	us
onq	zonguldak	tr
onr	monkira	au
ons	onslow	au
ont	ontario	us
onu	ono i lau	fj
onx	colon	pa
ony	olney	us
ooa	oskaloosa	us
ook	toksook bay	us
ool	gold coast	au
oom	cooma	au
oor	mooraberree	au
oot	onotoa	ki
opa	kopasker	is
opb	open bay	pg
opi	oenpelli	au
opl	opelousas	us
opo	porto	pt
ops	sinop	br
opu	balimo	pg
opw	opuwa	na
ora	oran	ar
orb	orebro	se
orc	orocue	co
ore	orleans	fr
orf	norfolk	us
orh	worcester	us
ori	port lions	us
orj	orinduik	gy
ork	cork	ie
orl	orlando	us
orm	northampton	gb
orn	oran	dz
oro	yoro	hn
orp	orapa	bw
orq	norwalk	us
orr	yorketown	au
ors	orpheus island resort	au
ort	northway	us
oru	oruro	bo
orv	noorvik	us
orw	ormara	pk
orx	oriximina	br
orz	orange walk	bz
osa	osaka	jp
osb	osage beach	us
osc	oscoda	us
osd	ostersund	se
ose	omora	pg
osg	ossima	pg
osh	oshkosh	us
osi	osijek	hr
osk	oskarshamn	se
osl	oslo	no
osm	mosul	iq
osn	osan	kr
oso	osborne mine	au
osr	ostrava	cz
oss	osh	kg
ost	ostend	be
osw	orsk	ru
osx	kosciusko	us
osy	namsos	no
osz	koszalin	pl
ota	mota	et
otc	bol	td
otd	contadora	pa
otg	worthington	us
oth	north bend	us
oti	pitu	id
otj	otjiwarongo	na
otk	tillamook	us
otl	boutilimit	mr
otm	ottumwa	us
otn	oaktown	us
oto	otto	us
otr	coto 47	cr
ots	anacortes	us
ott	cotriguacu	br
otu	otu	co
otv	ontong java	sb
oty	oria	pg
otz	kotzebue	us
oua	ouagadougou	bf
oud	oujda	ma
oue	ouesso	cg
oug	ouahigouya	bf
ouh	oudtshoorn	za
oui	ban houei	la
ouk	outer skerries	gb
oul	oulu	fi
oum	oum hadjer	td
oun	norman	us
our	batouri	cm
ous	ourinhos	br
out	bousso	td
ouu	ouanga	ga
ouz	zouerate	mr
ova	bekily	mg
ovb	novosibirsk	ru
ovd	oviedo	es
ove	oroville	us
ovg	overberg	za
ovl	ovalle	cl
ovr	olavarria	ar
ovs	sovetsky	ru
owa	owatonna	us
owb	owensboro	us
owd	norwood	us
owe	owendo	ga
owk	norridgewock	us
oxb	bissau	gw
oxc	oxford	us
oxd	oxford	us
oxf	oxford	gb
oxo	orientos	au
oxr	ventura	us
oxy	morney	au
oya	goya	ar
oye	oyem	ga
oyg	moyo	ug
oyk	oiapoque	br
oyl	moyale	ke
oyn	ouyen	au
oyo	tres arroyos	ar
oyp	st georges de loyapock	gf
oys	yosemite	us
oza	ozona	us
ozc	ozamis city	ph
ozg	zagora	ma
ozh	zaporozhye	ua
ozi	bobadilla	es
ozl	orzola	es
ozp	moron	es
ozr	ozark	us
ozu	montilla	es
ozz	ouarzazate	ma
paa	pa-an	mm
pab	bilaspur	in
pad	paderborn	de
pae	everett	us
paf	pakuba	ug
pag	pagadian	ph
pah	paducah	us
paj	para chinar	pk
pak	hanapepe	us
pal	palanquero	co
pan	pattani	th
pao	palo alto	us
pap	port au prince	ht
paq	palmer	us
par	paris	fr
pas	paros	gr
pat	patna	in
pau	pauk	mm
pav	paulo afonso	br
paw	pambwa	pg
pax	port de paix	ht
pay	pamol	my
paz	poza rica	mx
pbb	paranaiba	br
pbc	puebla atlixco	mx
pbd	porbandar	in
pbe	puerto berrio	co
pbf	pine bluff	us
pbg	plattsburgh	us
pbh	paro	bt
pbi	west palm beach	us
pbj	paama	vu
pbk	pack creek	us
pbl	puerto cabello	ve
pbm	paramaribo	sr
pbn	porto amboim	ao
pbo	paraburdoo	au
pbp	punta islita	cr
pbq	pimenta bueno	br
pbr	puerto barrios	gt
pbs	patong beach	th
pbt	puerto leda	py
pbu	putao	mm
pbv	porto dos gauchos	br
pbw	palibelo	id
pbx	porto alegre do norte	br
pby	peppers palm bay	au
pbz	plettenberg bay	za
pca	portage creek	us
pcb	pondok cabe	id
pcc	puerto rico	co
pcd	prairie du chien	us
pce	painter creek	us
pcf	potchefstroom	za
pcg	paso caballos	gt
pch	palacios	hn
pcj	puerto la victoria	py
pck	porcupine creek	us
pcl	pucallpa	pe
pcm	playa del carmen	mx
pcn	picton	nz
pco	punta colorada	mx
pcp	principe	st
pcq	phongsaly	la
pcr	puerto carreno	co
pcs	picos	br
pct	princeton	us
pcu	picayune	us
pcv	punta chivato	mx
pda	puerto inirida	co
pdb	pedro bay	us
pdc	mueo	nc
pdd	ponta de ouro	mz
pde	pandie pandie	au
pdf	prado	br
pdg	padang	id
pdi	pindiu	pg
pdl	ponta delgada	pt
pdn	parndana	au
pdo	pendopo	id
pdp	maldonado	uy
pdr	presidente dutra	br
pds	piedras negras	mx
pdt	pendleton	us
pdu	paysandu	uy
pdv	plovdiv	bg
pdx	portland	us
pdz	pedernales	ve
pea	penneshaw	au
peb	pebane	mz
pec	pelican	us
ped	pardubice	cz
pee	perm	ru
pef	peenemuende	de
peg	perugia	it
peh	pehuajo	ar
pei	pereira	co
pej	peschiei	it
pel	pelaneng	ls
pem	puerto maldonado	pe
pen	penang	my
pep	peppimenarti	au
peq	pecos city	us
per	perth	au
pes	petrozavodsk	ru
pet	pelotas	br
peu	puerto lempira	hn
pev	pecs	hu
pew	peshawar	pk
pex	pechora	ru
pey	penong	au
pez	penza	ru
pfa	paf warren	us
pfb	passo fundo	br
pfc	pacific city	us
pfd	port frederick	us
pfj	patreksfjordur	is
pfn	panama city	us
pfo	paphos	cy
pfq	parsabad	ir
pfr	ilebo	cd
pga	page	us
pgb	pangoa	pg
pgc	petersburg	us
pgd	punta gorda	us
pge	yegepa	pg
pgf	perpignan	fr
pgg	progresso	br
pgh	pantnagar	in
pgi	chitato	ao
pgk	pangkalpinang	id
pgl	pascagoula	us
pgm	port graham	us
pgn	pangia	pg
pgo	pagosa springs	us
pgp	porto alegre	st
pgr	paragould	us
pgs	peach springs	us
pgu	asaloyeh	ir
pgv	greenville	us
pgx	perigueux	fr
pgz	ponta grossa	br
pha	phan rang	vn
phb	parnaiba	br
phc	port harcourt	ng
phd	new philadelphia	us
phe	port hedland	au
phf	newport news	us
phh	phan thiet	vn
phi	pinheiro	br
phk	pahokee	us
phl	philadelphia	us
phn	port huron	us
pho	point hope	us
php	philip	us
phr	pacific harbor	fj
phs	phitsanulok	th
pht	paris	us
phu	phu vinh	vn
phw	phalaborwa	za
phx	phoenix	us
phy	phetchabun	th
phz	phi phi island	th
pia	peoria	us
pic	pine cay	tc
pif	pingtung	tw
pig	pitinga	br
pih	pocatello	us
pil	pilar	py
pim	pine mountain	us
pin	parintins	br
pio	pisco	pe
pip	pilot point	us
piq	pipillipai	gy
pir	pierre	us
pis	poitiers	fr
pit	pittsburgh	us
piu	piura	pe
piv	pirapora	br
piw	pikwitonei	ca
pix	pico island	pt
piz	point lay	us
pja	pajala	se
pjb	payson	us
pjc	pedro juan caballero	py
pjg	panjgur	pk
pjm	puerto jimenez	cr
pjs	port san juan	us
pjz	puerto juarez	mx
pka	napaskiak	us
pkb	parkersburg	us
pkc	petropavlovsk-kamchats	ru
pkd	park rapids	us
pke	parkes	au
pkf	park falls	us
pkg	pangkor	my
pkh	porto kheli	gr
pkj	playa grande	gt
pkk	pakokku	mm
pkl	pakatoa island	nz
pkm	port kaituma	gy
pkn	pangkalanbuun	id
pko	parakou	bj
pkp	puka puka	pf
pkr	pokhara	np
pks	paksane	la
pkt	port keats	au
pku	pekanbaru	id
pkv	pskov	ru
pkw	selebi-phikwe	bw
pky	palangkaraya	id
pkz	pakse	la
pla	planadas	co
plc	planeta rica	co
pld	playa samara	cr
ple	paiela	pg
plf	pala	td
plh	plymouth	gb
pli	palm island	vc
plj	placencia	bz
plk	point lookout	us
pll	ponta pelada	br
plm	palembang	id
pln	pellston	us
plo	port lincoln	au
plp	la palma	pa
plq	klaipeda	lt
plr	pell city	us
pls	providenciales	tc
plt	plato	co
plv	poltava	ua
plw	palu	id
plx	semipalatinsk	kz
ply	plymouth	us
plz	port elizabeth	za
pma	pemba	tz
pmb	pembina	us
pmc	puerto montt	cl
pmd	palmdale	us
pme	portsmouth	gb
pmg	ponta pora	br
pmh	portsmouth	us
pmi	palma mallorca	es
pmk	palm island	au
pml	port moller	us
pmm	phanom sarakham	th
pmn	pumani	pg
pmo	palermo	it
pmp	pimaga	pg
pmq	perito moreno	ar
pmr	palmerston north	nz
pms	palmyra	sy
pmt	paramakotoi	gy
pmu	paimiut	us
pmv	porlamar	ve
pmw	palmas	br
pmx	palmer	us
pmy	puerto madryn	ar
pmz	palmar	cr
pna	pamplona	es
pnb	porto nacional	br
pnc	ponca city	us
pnd	punta gorda	bz
pnf	peterson's point	us
png	paranagua	br
pnh	phnom penh	kh
pni	pohnpei	fm
pnj	peng lai	cn
pnk	pontianak	id
pnl	pantelleria	it
pnn	princeton	us
pno	pinotepa nacional	mx
pnp	popondetta	pg
pnq	pune	in
pnr	pointe-noire	cg
pns	pensacola	us
pnt	puerto natales	cl
pnu	panguitch	us
pnv	panevezys	lt
pnx	sherman-denison	us
pny	pondicherry	in
pnz	petrolina	br
poa	porto alegre	br
poc	la verne	us
pod	podor	sn
poe	fort polk	us
pof	poplar bluff	us
pog	port gentil	ga
poh	pocahontas	us
poi	potosi	bo
pol	pemba	mz
pom	port moresby	pg
pon	poptun	gt
poo	pocos de caldas	br
pop	puerto plata	do
poq	polk inlet	us
por	pori	fi
pos	port of spain	tt
pot	port antonio	jm
pou	poughkeepsie	us
pov	presov	sk
pow	portoroz	si
poy	powell	us
poz	poznan	pl
ppa	pampa	us
ppb	presidente prudente	br
ppc	prospect creek	us
ppe	puerto penasco	mx
ppf	parsons	us
ppg	pago pago	as
pph	peraitepuy	ve
ppi	port pirie	au
ppj	pulau panjang	id
ppk	petropavlovsk	kz
ppl	phaplu	np
ppm	pompano beach	us
ppn	popayan	co
ppo	powell point	bs
ppp	proserpine	au
ppq	paraparaumu	nz
ppr	pasir pangarayan	id
pps	puerto princesa	ph
ppt	papeete	pf
ppu	papun	mm
ppv	port protection	us
ppw	papa westray	gb
ppx	param	pg
ppy	pouso alegre	br
ppz	puerto paez	ve
pqc	phu quoc	vn
pqi	presque isle	us
pqm	palenque	mx
pqq	port macquarie	au
pqs	pilot station	us
pqt	qeqertaq	gl
pra	parana	ar
prb	paso robles	us
prc	prescott	us
prd	pardoo	au
pre	pore	co
prf	port johnson	us
prg	prague	cz
prh	phrae	th
pri	praslin island	sc
prj	capri	it
prk	prieska	za
prl	port oceanic	us
prm	portimao	pt
prn	pristina	rs
pro	perry	us
prp	propriano	fr
prq	pres. roque saenz pena	ar
prr	paruima	gy
prs	parasi	sb
prt	point retreat	us
pru	prome	mm
prv	prerov	cz
prw	prentice	us
prx	paris	us
pry	pretoria	za
prz	prineville	us
psa	pisa	it
psb	bellefonte	us
psc	pasco	us
psd	port said	eg
pse	ponce	pr
psf	pittsfield	us
psg	petersburg	us
psh	st peter	de
psi	pasni	pk
psj	poso	id
psk	dublin	us
psl	perth	gb
psn	palestine	us
pso	pasto	co
psp	palm springs	us
psr	pescara	it
pss	posadas	ar
pst	preston	cu
psu	putussibau	id
psv	papa stour	gb
psw	passos	br
psx	palacios	us
psy	port stanley	fk
psz	puerto suarez	bo
pta	port alsworth	us
ptb	petersburg	us
ptc	port alice	us
ptd	port alexander	us
ptf	malololailai	fj
ptg	polokwane	za
pth	port heiden	us
pti	port douglas	au
ptj	portland	au
ptk	pontiac	us
ptl	port armstrong	us
ptm	palmarito	ve
ptn	patterson	us
pto	pato branco	br
ptp	pointe-a-pitre	gp
ptq	porto de moz	br
ptr	pleasant harbour	us
pts	pittsburg	us
ptt	pratt	us
ptu	platinum	us
ptv	porterville	us
ptw	pottstown	us
ptx	pitalito	co
pty	panama city	pa
ptz	pastaza	ec
pua	puas	pg
pub	pueblo	us
puc	price	us
pud	puerto deseado	ar
pue	puerto obaldia	pa
puf	pau	fr
pug	port augusta	au
puh	pochutla	mx
pui	pureni	pg
puj	higuey	do
puk	pukarua	pf
pul	poulsbo	us
pum	pomala	id
pun	punia	cd
puo	prudhoe bay	us
pup	po	bf
puq	punta arenas	cl
pur	puerto rico	bo
pus	busan	kr
put	puttaparthi	in
puu	puerto asis	co
puv	poum	nc
puw	pullman	us
pux	puerto varas	cl
puy	pula	hr
puz	puerto cabezas	ni
pva	providencia	co
pvc	provincetown	us
pvd	providence	us
pve	el porvenir	pa
pvf	placerville	us
pvh	porto velho	br
pvi	paranavai	br
pvk	preveza	gr
pvo	portoviejo	ec
pvr	puerto vallarta	mx
pvs	provideniya	ru
pvu	provo	us
pvw	plainview	us
pvy	pope vanoy	us
pvz	painesville	us
pwd	plentywood	us
pwe	pevek	ru
pwi	pawi	et
pwl	purwokerto	id
pwm	portland	us
pwn	pitts town	bs
pwo	pweto	cd
pwq	pavlodar	kz
pwr	port walter	us
pwt	bremerton	us
pxh	prominent hill	au
pxl	polacca	us
pxm	puerto escondido	mx
pxo	porto santo	pt
pxr	surin	th
pxs	puerto de santa maria	es
pxu	pleiku	vn
pya	puerto boyaca	co
pyb	jeypore	in
pyc	playon chico	pa
pye	penrhyn island	ck
pyh	puerto ayacucho	ve
pyj	polyarnyj	ru
pyk	karaj	ir
pyl	perry island	us
pym	plymouth	us
pyn	payan	co
pyo	putumayo	ec
pyr	pyrgos	gr
pys	paradise	us
pyv	yaviza	pa
pyx	pattaya	th
pyy	pai	th
pza	paz de ariporo	co
pzb	pietermaritzburg	za
pze	penzance	gb
pzh	zhob	pk
pzi	panzhihua	cn
pzk	puka puka	ck
pzl	phinda	za
pzo	puerto ordaz	ve
pzu	port sudan	sd
pzy	piestany	sk
qbc	bella coola	ca
qbo	bochum	de
qca	makkah	sa
qce	copper mountain	us
qcu	akunnaaq	gl
qcy	coningsby	gb
qdh	ashford	gb
qdl	guarapari	br
qeq	embrach/rorbas	ch
qew	leicester	gb
qfb	freiburg	de
qfh	frederikshavn	dk
qfi	iginniarfik	gl
qfk	selje	no
qfq	maloy	no
qgl	st gallen	ch
qgn	tarragona	es
qgq	attu	gl
qgy	per	hu
qhj	hjorring	dk
qhu	husum	de
qhx	qionghai	cn
qii	lindau	de
qje	kitsissuarsuit	gl
qji	ikamiut	gl
qjv	skagen z7	dk
qjw	kjellerup	dk
qjy	kolobrzeg	pl
qkb	breckenridge	us
qks	keystone	us
qle	leeton	au
qlj	lucerne	ch
qls	lausanne	ch
qlz	ikast	dk
qmk	niaqornaarsuk	gl
qmo	mons	be
qmv	montvale	us
qmz	mainz	de
qnc	neuchatel	ch
qnm	namur	be
qob	ansbach	de
qow	owerri	ng
qpa	padova	it
qpl	ploiesti	ro
qpt	patos de minas	br
qpv	perisher valley	au
qpw	kangaatsiaq	gl
qqd	dover	gb
qqh	harwich	gb
qqr	ramsgate	gb
qqx	bath	gb
qqy	york	gb
qro	queretaro	mx
qrs	resita	ro
qrw	warri	ng
qry	ikerasaarsuk	gl
qsc	sao carlos	br
qsf	sétif	dz
qsr	salerno	it
qth	thredbo	au
qub	ubari	ly
qug	chichester	gb
qul	ulm	de
quo	uyo	ng
qup	saqqaq	gl
quy	wyton	gb
qvy	kouvola	fi
qwa	oshawa	ca
qwl	crackenback village	au
qwo	holstebro	dk
qwp	winter park	us
qwq	struer	dk
qwu	wuerzburg	de
qwz	best	nl
qxb	aix-en-provence	fr
qxf	vestbjerg	dk
qxk	st-genis	fr
qxv	svendborg	dk
qxz	woergl	at
qyc	drachten	nl
qyh	hengelo	nl
qyi	hilversum	nl
qyl	almelo	nl
qym	amersfoort	nl
qyp	apeldoorn	nl
qyq	sulsted	dk
qyt	paterswolde	nl
qyv	deventer	nl
qyx	uppsala	se
qyz	heerenveen	nl
qzb	zermatt	ch
qzc	smiggin holes	au
qzd	szeged	hu
qzf	font-romeu	fr
qzm	bullocks flat	au
raa	rakanda	pg
rab	rabaul	pg
rac	racine	us
rae	arar	sa
raf	rafaela	ar
rag	raglan	nz
rah	rafha	sa
rai	praia	cv
raj	rajkot	in
rak	marrakech	ma
ral	riverside	us
ram	ramingining	au
ran	ravenna	it
rao	ribeirao preto	br
rap	rapid city	us
raq	raha	id
rar	rarotonga	ck
ras	rasht	ir
rat	raduzhnyi	ru
rav	cravo norte	co
raw	arawa	pg
rax	oram	pg
raz	rawala kot	pk
rba	rabat	ma
rbb	borba	br
rbc	robinvale	au
rbe	ratanakiri	kh
rbf	big bear	us
rbg	roseburg	us
rbh	brooks lodge	us
rbi	rabi	fj
rbj	rebun	jp
rbk	rancho	us
rbl	red bluff	us
rbm	straubing	de
rbn	fort jefferson	us
rbo	robore	bo
rbp	rabaraba	pg
rbq	rurrenabaque	bo
rbr	rio branco	br
rbs	orbost	au
rbt	marsabit	ke
rbu	roebourne	au
rbv	ramata	sb
rbw	walterboro	us
rbx	rumbek	ss
rby	ruby	us
rcb	richards bay	za
rce	roche harbor	us
rch	riohacha	co
rck	rockdale	us
rcl	redcliffe	vu
rcm	richmond	au
rcn	american river	au
rco	rochefort	fr
rcp	cinder river	us
rcq	reconquista	ar
rcr	rochester	us
rcs	rochester	gb
rct	reed city	us
rcu	rio cuarto	ar
rcy	rum cay	bs
rda	rockhampton downs	au
rdb	red dog	us
rdc	redencao	br
rdd	redding	us
rde	merdey	id
rdg	reading	us
rdm	redmond	us
rdn	redang	my
rdr	red river	us
rds	rincon de los sauces	ar
rdt	richard toll	sn
rdu	raleigh	us
rdv	red devil	us
rdz	rodez	fr
rea	reao	pf
reb	rechlin	de
rec	recife	br
red	reedsville	us
reg	reggio calabria	it
reh	rehoboth beach	us
rei	regina	gf
rek	reykjavik	is
rel	trelew	ar
ren	orenburg	ru
reo	rome	us
rep	siem reap	kh
req	reko diq	pk
rer	retalhuleu	gt
res	resistencia	ar
ret	rost	no
reu	reus	es
rew	rewa	in
rex	reynosa	mx
rey	reyes	bo
rez	resende	br
rfa	rafai	cf
rfg	refugio	us
rfk	anguilla	us
rfn	raufarhofn	is
rfp	raiatea	pf
rfr	rio frio	cr
rfs	rosita	ni
rga	rio grande	ar
rge	porgera	pg
rgh	balurghat	in
rgi	rangiroa	pf
rgk	gorno-altaysk	ru
rgl	rio gallegos	ar
rgn	yangon	mm
rgo	orang	kp
rgr	ranger	us
rgs	burgos	es
rgt	rengat	id
rha	reykholar	is
rhd	rio hondo	ar
rhe	reims	fr
rhg	ruhengeri	rw
rhi	rhinelander	us
rhl	roy hill	au
rhn	rosh pina	na
rho	rhodes	gr
rhp	ramechhap	np
ria	santa maria	br
rib	riberalta	bo
ric	richmond	us
rid	richmond	us
rie	rice lake	us
rif	richfield	us
rig	rio grande	br
rij	rioja	pe
rik	carrillo	cr
ril	rifle	us
rim	rodriguez de mendoza	pe
rin	ringi cove	sb
rio	rio de janeiro	br
ris	rishiri	jp
rit	rio tigre	pa
riw	riverton	us
rix	riga	lv
riy	riyan mukalla	ye
riz	rio alzucar	pa
rja	rajahmundry	in
rjb	rajbiraj	np
rjh	rajshahi	bd
rji	rajouri	in
rjk	rijeka	hr
rjl	logrono	es
rjn	rafsanjan	ir
rka	aratika	pf
rkc	yreka	us
rkd	rockland	us
rkh	rock hill	us
rki	rokot	id
rko	sipora	id
rkp	rockport	us
rkr	poteau	us
rks	rock springs	us
rkt	ras al khaimah	ae
rku	yule island	pg
rkw	rockwood	us
rky	rokeby	au
rkz	xigaze/rikaze	cn
rla	rolla	us
rld	richland	us
rlg	rostock-laage	de
rlk	bayannur	cn
rlo	merlo	ar
rlp	rosella plains	au
rlr	isalo	mg
rlt	arlit	ne
rlu	bornite	us
rma	roma	au
rmb	buraimi	om
rmc	rockford	us
rmd	ramagundam	in
rme	rome	us
rmf	marsa alam	eg
rmg	rome	us
rmi	rimini	it
rmk	renmark	au
rmn	rumginae	pg
rmp	rampart	us
rmq	taichung	tw
rms	ramstein	de
rmt	rimatara	pf
rmu	corvera	es
rmy	mariposa	us
rna	arona	sb
rnb	ronneby	se
rnc	mcminnville	us
rne	roanne	fr
rng	rangely	us
rnh	new richmond	us
rni	corn island	ni
rnj	yoronjima	jp
rnl	rennell	sb
rnm	qarn alam	om
rnn	rønne	dk
rno	reno	us
rnp	rongelap island	mh
rnr	robinson river	pg
rns	rennes	fr
rnt	renton	us
rnu	ranau	my
rnz	rensselaer	us
roa	roanoke	us
roc	rochester	us
rod	robertson	za
rog	rogers	us
roh	robinhood	au
roi	roi et	th
rok	rockhampton	au
rol	roosevelt	us
rom	rome	it
ron	rondon	co
roo	rondonopolis	br
rop	rota	mp
ror	koror	pw
ros	rosario	ar
rot	rotorua	nz
rou	rousse	bg
rov	rostov	ru
row	roswell	us
rox	roseau	us
roy	rio mayo	ar
roz	rota	es
rpa	rolpa	np
rpb	roper bar	au
rpm	ngukurr	au
rpn	rosh pina	il
rpr	raipur	in
rpv	roper valley	au
rpx	roundup	us
rqw	qayyarah	iq
rra	ronda	es
rre	marree	au
rrg	rodrigues island	mu
rri	barora	sb
rrk	rourkela	in
rrl	merrill	us
rrm	marromeu	mz
rrn	serra norte	br
rro	naples	it
rrr	raroia	pf
rrs	roros	no
rrt	warroad	us
rrv	robinson river	au
rsa	santa rosa	ar
rsb	roseberth	au
rsd	rock sound	bs
rsg	serra pelada	br
rsh	russian mission	us
rsi	rio sidra	pa
rsj	rosario	us
rsk	ransiki	id
rsl	russell	us
rsn	ruston	us
rsp	raspberry strait	us
rss	roseires	sd
rst	rochester	us
rsu	yeosu	kr
rsx	rouses point	us
rta	rotuma island	fj
rtb	roatan	hn
rtc	ratnagiri	in
rtd	rotunda	us
rte	marguerite bay	us
rtg	ruteng	id
rti	roti	id
rtl	spirit lake	us
rtm	rotterdam	nl
rtn	raton	us
rtp	rutland plains	au
rts	rottnest island	au
rtw	saratov	ru
rty	merty	au
rua	arua	ug
rud	shahrud	ir
rue	butembo	cd
ruf	yuruf	id
rug	rugao	cn
ruh	riyadh	sa
rui	ruidoso	us
ruk	rukumkot	np
rum	rumjatar	np
run	st denis de la reunion	re
rup	rupsi	in
rur	rurutu	pf
rus	marau sound	sb
rut	rutland	us
ruu	ruti	pg
ruv	rubelsanto	gt
ruy	copan	hn
rva	farafangana	mg
rvc	rivercess	lr
rvd	rio verde	br
rve	saravena	co
rvk	roervik	no
rvn	rovaniemi	fi
rvo	reivilo	za
rvr	green river	us
rvt	ravensthorpe	au
rvv	rairua	pf
rvy	rivera	uy
rwb	rowan bay	us
rwf	redwood falls	us
rwi	rocky mount	us
rwl	rawlins	us
rwn	rovno	ua
rws	sumare	br
rxa	raudha	ye
rxe	rexburg	us
rxs	roxas city	ph
ryb	rybinsk	ru
ryk	rahim yar khan	pk
ryn	royan	fr
ryo	rio turbio	ar
rza	santa cruz	ar
rze	rzeszow	pl
rzn	ryazan	ru
rzp	taytay sandoval	ph
rzr	ramsar	ir
rzs	sawan	pk
rzz	roanoke rapids	us
saa	saratoga	us
sab	saba island	bq
sac	sacramento	us
sad	safford	us
sae	sangir	id
sag	sagwon	us
sah	sanaa	ye
sak	saudarkrokur	is
sal	san salvador	sv
sam	salamo	pg
san	san diego	us
sao	sao paulo	br
sap	san pedro sula	hn
saq	san andros	bs
sar	sparta	us
sas	salton city	us
sat	san antonio	us
sau	sawu	id
sav	savannah	us
sax	sambu	pa
say	siena	it
saz	sasstown	lr
sba	santa barbara	us
sbb	santa barbara de barinas	ve
sbc	selbang	pg
sbe	suabi	pg
sbf	sardeh band	af
sbg	sabang	id
sbh	gustavia	bl
sbi	koundara	gn
sbj	sao mateus	br
sbk	tremuson	fr
sbl	santa ana	bo
sbm	sheboygan	us
sbn	south bend	us
sbo	salina	us
sbq	sibi	pk
sbr	saibai island	au
sbs	steamboat springs	us
sbt	san bernardino	us
sbu	springbok	za
sbv	sabah	pg
sbw	sibu	my
sbx	shelby	us
sby	salisbury-ocean city	us
sbz	sibiu	ro
sca	santa catalina	co
scb	scribner	us
scc	prudhoe bay/deadhorse	us
scd	sulaco	hn
sce	state college	us
scg	spring creek	au
sch	schenectady	us
sci	san cristobal	ve
scj	smith cove	us
scl	santiago	cl
scm	scammon bay	us
scn	saarbruecken	de
sco	aktau	kz
scp	st crepin	fr
scq	santiago de compostela	es
sct	socotra	ye
scu	santiago	cu
scv	suceava	ro
scw	syktyvkar	ru
scx	salina cruz	mx
scy	puerto baquerizo moreno	ec
scz	santa cruz island	sb
sdb	saldanha bay	za
sdc	sandcreek	gy
sdd	lubango	ao
sde	santiago del estero	ar
sdf	louisville	us
sdg	sanandaj	ir
sdh	santa rosa copan	hn
sdi	saidor	pg
sdj	sendai	jp
sdk	sandakan	my
sdl	sundsvall	se
sdn	sandane	no
sdo	ryotsu sado island	jp
sdp	sand point	us
sdq	santo domingo	do
sdr	santander	es
sds	sado shima	jp
sdt	saidu sharif	pk
sdx	sedona	us
sdy	sidney	us
sdz	shetland islands	gb
sea	seattle	us
seb	sebha	ly
sed	sedom	il
sef	sebring	us
seg	selinsgrove	us
seh	senggeh	id
sei	senhor do bonfim	br
sel	seoul	kr
seo	seguela	ci
sep	stephenville	us
seq	sungai pakning	id
ser	seymour	us
ses	selma	us
set	san esteban	hn
seu	seronera	tz
sev	severodoneck	ua
sew	siwa	eg
sey	selibaby	mr
sez	mahe island	sc
sfa	sfax	tn
sfc	st francois	gp
sfd	san fernando de apure	ve
sfe	san fernando	ph
sfg	st martin	mf
sfh	san felipe	mx
sfj	kangerlussuaq	gl
sfk	soure	br
sfl	são filipe	cv
sfm	sanford	us
sfn	santa fe	ar
sfo	san francisco	us
sfp	surfers paradise	au
sfq	sanliurfa	tr
sfr	san fernando	us
sfs	subic bay	ph
sft	skelleftea	se
sfu	safia	pg
sfv	santa fe do sul	br
sfw	santa fe	pa
sfx	san felix	ve
sfy	springfield	us
sfz	pawtucket	us
sga	sheghnan	af
sgb	singaua	pg
sgc	surgut	ru
sgd	sonderborg	dk
sge	siegen	de
sgf	springfield	us
sgg	simanggang	my
sgh	springfield	us
sgi	sargodha	pk
sgj	sagarai	pg
sgk	sangapi	pg
sgm	san ignacio	mx
sgn	ho chi minh city	vn
sgo	st george	au
sgp	shay gap	au
sgq	sanggata	id
sgr	sugar land	us
sgs	sanga sanga	ph
sgt	stuttgart	us
sgu	saint george	us
sgv	sierra grande	ar
sgw	saginaw bay	us
sgx	songea	tz
sgy	skagway	us
sgz	songkhla	th
sha	shanghai	cn
shb	nakashibetsu	jp
shc	indaselassie	et
shd	staunton	us
she	shenyang	cn
shg	shungnak	us
shh	shishmaref	us
shi	shimojishima	jp
shj	sharjah	ae
shk	sehonghong	ls
shl	shillong	in
shm	shirahama	jp
shn	shelton	us
sho	sokcho	kr
shp	qinhuangdao	cn
shq	southport	au
shr	sheridan	us
shs	shashi	cn
sht	shepparton	au
shu	smith point	au
shv	shreveport	us
shw	sharurah	sa
shx	shageluk	us
shy	shinyanga	tz
shz	seshutes	ls
sia	xi'an	cn
sib	sibiti	cg
sic	sinop	pa
sid	sal	cv
sie	sines	pt
sif	simara	np
sih	silgadi doti	np
sii	sidi ifni	ma
sij	siglufjordur	is
sik	sikeston	us
sil	sila	pg
sim	simbai	pg
sin	singapore	sg
sio	smithton	au
sip	simferopol	ua
siq	singkep	id
sir	sion	ch
sis	sishen	za
sit	sitka	us
siu	siuna	ni
siv	sullivan	us
siw	sibisa	id
six	singleton	au
siy	montague	us
siz	sissano	pg
sja	san juan	pe
sjb	san joaquin	bo
sjc	san jose	us
sjd	san jose del cabo	mx
sje	san jose del gua	co
sjf	st john island	vi
sjg	san pedro jagua	co
sjh	san juan del cesar	co
sji	san jose	ph
sjj	sarajevo	ba
sjk	sao jose dos campos	br
sjl	sao gabriel	br
sjm	san juan	do
sjn	st johns	us
sjo	san josé	cr
sjp	sao jose do rio preto	br
sjq	sesheke	zm
sjr	san juan d ur	co
sjs	san jose	bo
sjt	san angelo	us
sju	san juan	pr
sjv	san javier	bo
sjw	shijiazhuang	cn
sjx	sartaneja	bz
sjy	seinajoki	fi
sjz	sao jorge island	pt
skb	basseterre	kn
skc	suki	pg
skd	samarkand	uz
ske	skien	no
skg	thessaloniki	gr
skh	surkhet	np
ski	skikda	dz
skj	sitkinak island	us
skk	shaktoolik	us
skl	isle of skye	gb
skm	skeldon	gy
skn	stokmarknes	no
sko	sokoto	ng
skp	skopje	mk
skq	sekakes	ls
skr	shakiso	et
sks	vojens	dk
skt	sialkot	pk
sku	skiros	gr
skv	santa katarina	eg
skw	skwentna	us
skx	saransk	ru
sky	sandusky	us
skz	sukkur	pk
sla	salta	ar
slb	storm lake	us
slc	salt lake city	us
sld	sliac	sk
sle	salem	us
slf	sulayel	sa
slg	siloam springs	us
slh	sola	vu
sli	solwezi	zm
slj	chandler	au
slk	saranac lake	us
sll	salalah	om
slm	salamanca	es
sln	salina	us
slo	salem	us
slp	san luis potosi	mx
slq	sleetmute	us
slr	sulphur springs	us
sls	silistra	bg
slt	salida	us
slu	castries	lc
slv	simla	in
slw	saltillo	mx
slx	salt cay	tc
sly	salekhard	ru
slz	são luis	br
sma	santa maria	pt
smb	cerro sombrero	cl
smc	santa maria	co
sme	somerset	us
smg	santa maria	pe
smh	sapmanga	pg
smi	samos	gr
smj	sim	pg
smk	st michael	us
sml	stella maris	bs
smm	semporna	my
smn	salmon	us
smo	santa monica	us
smp	stockholm	pg
smq	sampit	id
smr	santa marta	co
sms	sainte marie	mg
smt	sun moon lake	tw
smu	sheep mountain	us
smv	st moritz	ch
smw	smara	ma
smx	santa maria	us
smy	simenti	sn
smz	stoelmans eiland	sr
sna	santa ana	us
snb	snake bay	au
snc	salinas	ec
snd	seno	la
sne	sao nicolau	cv
snf	san felipe	ve
sng	san ignacio de velasco	bo
snh	stanthorpe	au
sni	sinoe	lr
snj	san julian	cu
snk	snyder	us
snl	shawnee	us
snm	san ignacio de m	bo
snn	shannon	ie
sno	sakon nakhon	th
snp	saint paul island	us
snq	san quintin	mx
snr	st nazaire	fr
sns	salinas	us
snt	sabana de torres	co
snu	santa clara	cu
snv	santa elena	ve
snw	thandwe	mm
snx	sabana de mar	do
sny	sidney	us
snz	santa cruz	br
soa	soc trang	vn
sob	sármellék	hu
soc	solo city	id
sod	sorocaba	br
soe	souanke	cg
sof	sofia	bg
sog	sogndal	no
soh	solita	co
soi	south molle island	au
soj	sorkjosen	no
sok	semongkong	ls
sol	solomon	us
som	san tome	ve
son	espiritu santo	vu
soo	soderhamn	se
sop	southern pines	us
soq	sorong	id
sor	al thaurah	sy
sot	sodankyla	fi
sou	eastleigh near southampton	gb
sov	seldovia	us
sow	show low	us
sox	sogamoso	co
soy	stronsay	gb
soz	solenzara	fr
spa	spartanburg	us
spc	santa cruz de la palma	es
spd	saidpur	bd
spe	sepulot	my
spf	spearfish	us
spg	saint petersburg	us
sph	sopu	pg
spi	springfield	us
spj	sparta	gr
spk	sapporo	jp
spm	spangdahlem	de
spn	saipan	mp
spo	san pablo	es
spp	menongue	ao
spq	san pedro	us
spr	san pedro	bz
sps	wichita falls	us
spt	sipitang	my
spu	split	hr
spv	sepik plains	pg
spw	spencer	us
spy	san pedro	ci
spz	springdale	us
sqa	santa ynez	us
sqb	santa ana	co
sqc	southern cross	au
sqe	san luis de pale	co
sqf	solano	co
sqg	sintang	id
sqh	son-la	vn
sqi	sterling rockfalls	us
sqk	sidi barani	eg
sql	san carlos	us
sqm	são miguel de aragao	br
sqn	sanana	id
sqo	storuman	se
sqq	siauliai	lt
sqr	soroako	id
sqs	san ignacio	bz
sqt	samarai island	pg
squ	saposoa	pe
sqv	sequim	us
sqw	skive	dk
sqx	sao miguel do oeste	br
sqy	sao lourenco do sul	br
sqz	scampton	gb
sra	santa rosa	br
srb	santa rosa	bo
src	searcy	us
srd	san ramon	bo
sre	sucre	bo
srf	san rafael	us
srg	semarang	id
srh	sarh	td
sri	samarinda	id
srj	san borja	bo
srl	santa rosalia	mx
srm	sandringham	au
srn	strahan	au
sro	santana ramos	co
srp	stord	no
srq	sarasota	us
srr	stradbroke island	au
srs	san marcos	co
srt	soroti	ug
sru	santa cruz	us
srv	stony river	us
srw	salisbury	us
srx	sert	ly
sry	sary	ir
srz	santa cruz	bo
ssa	salvador	br
ssc	sumter	us
ssd	san felipe	co
sse	sholapur	in
ssg	malabo	gq
ssh	sharm el-sheikh	eg
ssi	brunswick	us
ssj	sandnessjoen	no
ssk	sturt creek	au
ssl	santa rosalia	co
ssm	sault sainte marie	us
sso	sao lourenco	br
ssp	silver plains	au
ssq	la sarre	ca
ssr	sara	vu
sss	siassi	pg
sst	santa teresita	ar
ssu	white sulphur springs	us
ssv	siasi	ph
ssw	stuart island	us
ssy	m'banza congo	ao
ssz	santos	br
sta	skjern	dk
stb	santa barbara ed	ve
stc	saint cloud	us
std	santo domingo	ve
ste	stevens point	us
stf	stephen island	au
stg	st george island	us
sth	strathmore	au
sti	santiago	do
stj	st joseph	us
stk	sterling	us
stl	st louis	us
stm	santarem	br
sto	stockholm	se
stq	st marys	us
str	stuttgart	de
sts	santa rosa	us
stt	charlotte amalie	vi
stu	santa cruz	bz
stv	surat	in
stw	stavropol	ru
stx	christiansted	vi
sty	salto	uy
stz	santa terezinha	br
sua	stuart	us
sub	surabaya	id
suc	sundance	us
sud	stroud	us
sue	sturgeon bay	us
suf	lamezia terme	it
sug	surigao	ph
suh	sur	om
sui	sukhumi	ge
suj	satu mare	ro
suk	samcheok	kr
sul	sui	pk
sun	sun valley	us
suo	sun river	us
sup	sumenep	id
suq	sucua	ec
sur	summer beaver	ca
sut	sumbawanga	tz
suu	fairfield	us
suv	suva	fj
suw	superior	us
sux	sioux city	us
suz	suria	pg
sva	savoonga	us
svb	sambava	mg
svc	silver city	us
svd	st vincent	vc
sve	susanville	us
svf	save	bj
svg	stavanger	no
svh	statesville	us
svi	san vicente	co
svj	svolvaer	no
svk	silver creek	bz
svl	savonlinna	fi
svm	st pauls	au
svp	kuito	ao
svq	sevilla	es
svs	stevens village	us
svt	savuti	bw
svu	savusavu	fj
svv	san salvador de	ve
svw	sparrevohn	us
svx	ekaterinburg	ru
svy	savo	sb
svz	san antonio	ve
swa	shantou	cn
swb	shaw river	au
swc	stawell	au
swd	seward	us
swe	siwea	pg
swf	newburgh	us
swg	satwag	pg
swh	swan hill	au
swj	south west bay	vu
swl	spanish wells	bs
swm	suia-missu	br
swn	sahiwal	pk
swo	stillwater	us
swp	swakopmund	na
swq	sumbawa	id
swr	silur	pg
sws	swansea	gb
swt	strzhewoi	ru
swu	suwon	kr
swv	shikarpur	pk
sww	sweetwater	us
swx	shakawe	bw
swy	sitiawan	my
sxa	sialum	pg
sxb	strasbourg	fr
sxe	sale	au
sxg	senanga	zm
sxh	sehulea	pg
sxi	sirri island	ir
sxj	shanshan	cn
sxk	saumlaki	id
sxl	sligo	ie
sxm	philipsburg	sx
sxn	suapan	bw
sxo	sao felix do araguaia	br
sxp	sheldon point	us
sxq	soldotna	us
sxr	srinagar	in
sxs	sahabat 16	my
sxt	taman negara	my
sxu	soddu	et
sxv	salem	in
sxw	sauren	pg
sxx	sao felix do xingu	br
sxy	sidney	us
sxz	siirt	tr
sya	shemya	us
syb	seal bay	us
syc	shiringayoc	pe
syd	sydney	au
sye	sadah	ye
syf	silva bay	ca
syh	syangboche	np
syi	shelbyville	us
syj	sirjan	ir
syk	stykkisholmur	is
syl	san miguel	us
sym	simao	cn
syn	stanton	us
syo	shonai	jp
syp	santiago	pa
syq	san jose	cr
syr	syracuse	us
sys	suncheon	kr
syt	saint yan	fr
syu	sue island	au
syv	sylvester	us
syw	sehwen sharif	pk
syx	sanya	cn
syy	stornoway	gb
syz	shiraz	ir
sza	soyo	ao
szc	santa cruz	cr
sze	semera	et
szf	samsun	tr
szg	salzburg	at
szh	senipah	id
szi	zaisan	kz
szj	siguanea	cu
szk	skukuza	za
szl	kansas	us
szm	sesriem	na
szp	santa paula	us
szq	saenz pena	ar
szr	stara zagora	bg
szs	stewart island	nz
szt	s.cristobal del casas	mx
szu	segou	ml
szv	suzhou	cn
szw	schwerin	de
szx	shenzhen	cn
szy	szymany	pl
szz	szczecin	pl
taa	tarapaina	sb
tab	tobago	tt
tac	tacloban	ph
tad	trinidad	us
tae	daegu	kr
tag	tagbilaran	ph
tah	tanna	vu
tai	taiz	ye
tak	takamatsu	jp
tal	tanana	us
tam	tampico	mx
tan	tangalooma	au
tao	qingdao	cn
tap	tapachula	mx
taq	tarcoola	au
tar	taranto	it
tas	tashkent	uz
tat	poprad	sk
tau	tauramena	co
tav	fiti'uta village	as
taw	tacuarembo	uy
tax	taliabu	id
tay	tartu	ee
taz	dashoguz	tm
tba	tabibuga	pg
tbb	tuy hoa	vn
tbc	tuba city	us
tbd	timbiqui	co
tbe	timbunke	pg
tbf	tabiteuea north	ki
tbg	tabubil	pg
tbh	tablas	ph
tbi	the bight	bs
tbj	tabarka	tn
tbk	timber creek	au
tbl	tableland	au
tbm	tumbang samba	id
tbn	fort leonard wood	us
tbo	tabora	tz
tbp	tumbes	pe
tbq	tarabo	pg
tbr	statesboro	us
tbs	tbilisi	ge
tbt	tabatinga	br
tbu	nuku'alofa	to
tbv	tabal	mh
tbw	tambov	ru
tby	tsabong	bw
tbz	tabriz	ir
tca	tennant creek	au
tcb	treasure cay	bs
tcc	tucumcari	us
tcd	tarapaca	co
tce	tulcea	ro
tcf	tocoa	hn
tcg	tacheng	cn
tch	tchibanga	ga
tci	tenerife	es
tcj	torembi	pg
tck	tinboli	pg
tcl	tuscaloosa	us
tcn	tehuacan	mx
tco	tumaco	co
tcp	taba	eg
tcq	tacna	pe
tcr	tuticorin	in
tcs	truth or consequences	us
tct	takotna	us
tcu	thaba nchu	za
tcw	tocumwal	au
tcx	tabas	ir
tcy	terrace bay	na
tcz	tengchong	cn
tda	trinidad	co
tdb	tetabedi	pg
tdd	trinidad	bo
tdg	tandag	ph
tdj	tadjoura	dj
tdk	taldy-kurgan	kz
tdl	tandil	ar
tdn	theda	au
tdo	toledo	us
tdp	trompeteros	pe
tdr	theodore	au
tds	sasereme	pg
tdt	timbavati	za
tdv	tanandava	mg
tdx	trat	th
tea	tela	hn
teb	teterboro	us
tec	telemaco borba	br
ted	thisted	dk
tee	tbessa	dz
tef	telfer	au
teg	tenkodogo	bf
teh	tetlin	us
tei	tezu	in
tek	tatitlek	us
tel	telupid	my
tem	temora	au
ten	tongren	cn
teo	terapo	pg
tep	teptep	pg
teq	tekirdag	tr
ter	terceira island	pt
tes	tessenei	er
tet	tete	mz
teu	te anau	nz
tex	telluride	us
tey	thingeyri	is
tez	tezpur	in
tfb	tifalmin	pg
tfc	taormina	it
tff	tefe	br
tfi	tufi	pg
tfl	teofilo otoni	br
tfm	telefomin	pg
tfr	ramadan	eg
tft	taftan	pk
tgb	tagbita	ph
tgc	tanjung manis	my
tgd	podgorica	me
tge	tuskegee	us
tgg	kuala terengganu	my
tgh	tongoa	vu
tgi	tingo maria	pe
tgj	tiga	nc
tgk	taganrog	ru
tgl	tagula	pg
tgm	tirgu mures	ro
tgn	traralgon	au
tgo	tongliao	cn
tgp	bor	ru
tgq	tangara da serra	br
tgr	touggourt	dz
tgs	chokwe	mz
tgt	tanga	tz
tgu	tegucigalpa	hn
tgv	targovishte	bg
tgz	tuxtla gutierrez	mx
tha	tullahoma	us
thb	thaba-tseka	ls
thc	tchien	lr
the	teresina	br
thg	thangool	au
thh	taharoa	nz
thi	tichitt	mr
thk	thakhek	la
thl	tachilek	mm
thm	thompsonfield	us
thn	trollhattan	se
tho	thorshofn	is
thp	thermopolis	us
thq	tianshui	cn
thr	tehran	ir
ths	sukhothai (sawankolok)	th
tht	tamchakett	mr
thu	pituffik	gl
thv	york	us
thx	turukhansk	ru
thy	thohoyandou	za
thz	tahoua	ne
tia	tirana	al
tib	tibu	co
tic	tinak island	mh
tid	tiaret	dz
tie	tippi	et
tif	taif	sa
tig	tingwon	pg
tih	tikehau atoll	pf
tii	tirinkot	af
tij	tijuana	mx
til	inverlake	ca
tim	tembagapura	id
tin	tindouf	dz
tio	tilin	mm
tip	tripoli	ly
tiq	tinian	mp
tir	tirupati	in
tis	thursday island	au
tiu	timaru	nz
tiv	tivat	me
tiw	tacoma	us
tix	titusville	us
tiy	tidjikja	mr
tiz	tari	pg
tja	tarija	bo
tjb	tanjung balai	id
tjc	ticantiki	pa
tjg	tanjung warukin	id
tjh	toyooka	jp
tji	trujillo	hn
tjk	tokat	tr
tjm	tyumen	ru
tjn	takume	pf
tjq	tanjung pandan	id
tjs	tanjung selor	id
tju	kulyab	tj
tjv	thanjavur	in
tka	talkeetna	us
tkb	tekadu	pg
tkc	tiko	cm
tkd	takoradi	gh
tke	tenakee springs	us
tkf	truckee	us
tkg	bandar lampung	id
tkh	takhli	th
tki	tokeen	us
tkj	tok	us
tkk	truk	fm
tkl	taku lodge	us
tkm	tikal	gt
tkn	tokunoshima	jp
tko	tlokoeng	ls
tkp	takapoto	pf
tkq	kigoma	tz
tkr	thakurgaon	bd
tks	tokushima	jp
tkt	tak	th
tku	turku	fi
tkv	tatakoto	pf
tkw	tekin	pg
tkx	takaroa	pf
tky	turkey creek	au
tkz	tokoroa	nz
tla	teller	us
tlb	tarbela	pk
tld	tuli block	bw
tle	tulear	mg
tlf	telida	us
tlg	tulagi island	sb
tlh	tallahassee	us
tli	tolitoli	id
tlj	tatalina	us
tll	tallinn	ee
tlm	tlemcen	dz
tln	hyeres	fr
tlo	tol	pg
tlp	tumolbil	pg
tlq	turpan	cn
tlr	tulare	us
tls	toulouse	fr
tlt	tuluksak	us
tlu	tolu	co
tlv	tel aviv yafo	il
tlw	talasea	pg
tlx	talca	cl
tly	plastun	ru
tlz	catalao	br
tma	tifton	us
tmc	tambolaka	id
tmd	timbedra	mr
tme	tame	co
tmg	tomanggong	my
tmh	tanahmerah	id
tmi	tumling tar	np
tmj	termez	uz
tmk	tamky	vn
tml	tamale	gh
tmm	tamatave	mg
tmn	tamana island	ki
tmo	tumeremo	ve
tmp	tampere	fi
tmq	tambao	bf
tmr	tamanrasset	dz
tms	sao tome island	st
tmt	trombetas	br
tmu	tambor	cr
tmw	tamworth	au
tmx	timimoun	dz
tmy	tiom	id
tmz	thames	nz
tna	jinan	cn
tnb	tanah grogot	id
tnc	tin city	us
tnd	trinidad	cu
tne	tanegashima	jp
tnf	toussus-le-noble	fr
tng	tangier	ma
tnh	tonghua	cn
tni	satna	in
tnj	tanjung pinang	id
tnk	tununak	us
tnl	ternopol	ua
tnm	teniente r. marsh martin	aq
tnn	tainan	tw
tno	tamarindo	cr
tnp	twentynine palms	us
tnq	teraina	ki
tnr	antananarivo	mg
tns	tungsten	ca
tnu	newton	us
tnv	tabuaeran	ki
tnw	tena	ec
tnx	stung treng	kh
tnz	tosontsengel	mn
toa	torrance	us
tob	tobruk	ly
toc	toccoa	us
tod	tioman	my
toe	tozeur	tn
tof	tomsk	ru
tog	togiak village	us
toh	torres	vu
toi	troy	us
tok	torokina	pg
tol	toledo	us
tom	tombouctou	ml
ton	tonu	pg
too	san vito	cr
top	topeka	us
toq	tocopilla	cl
tor	torrington	us
tos	tromso	no
tot	totness	sr
tou	touho	nc
tov	tortola	vg
tow	toledo	br
tox	tobolsk	ru
toy	toyama	jp
toz	touba	ci
tpa	tampa	us
tpc	tarapoa	ec
tpe	taipei	tw
tpg	taiping	my
tph	tonopah	us
tpi	tapini	pg
tpj	taplejung	np
tpk	tapaktuan	id
tpl	temple	us
tpn	tiputini	ec
tpo	tanalian point	us
tpp	tarapoto	pe
tpq	tepic	mx
tpr	tom price	au
tps	trapani	it
tpt	tapeta	lr
tpu	tikapur	np
tpx	tupai	pf
tqd	al fallujah	iq
tql	tarko-sale	ru
tqn	taluqan	af
tqr	san domino island	it
tqs	tres esquinas	co
tra	taramajima	jp
trb	turbo	co
trc	torreon	mx
trd	trondheim	no
tre	tiree	gb
trg	tauranga	nz
trh	trona	us
tri	blountville	us
trj	tarakbits	pg
trk	tarakan	id
trl	terrell	us
trm	thermal	us
trn	turin	it
tro	taree	au
trp	tree point	us
trq	tarauaca	br
trr	trincomalee	lk
trs	trieste	it
trt	tremonton	us
tru	trujillo	pe
trv	thiruvananthapuram	in
trw	tarawa	ki
trx	trenton	us
try	tororo	ug
trz	tiruchirapally	in
tsb	tsumeb	na
tsc	taisha	ec
tsd	tshipise	za
tse	astana	kz
tsg	tanacross	us
tsh	tshikapa	cd
tsi	tsili tsili	pg
tsj	tsushima	jp
tsk	taskul	pg
tsl	tamuin	mx
tsm	taos	us
tsn	tianjin	cn
tsp	tehachapi	us
tsq	torres	br
tsr	timisoara	ro
tst	trang	th
tsu	tabiteuea south	ki
tsv	townsville	au
tsw	tsewi	pg
tsx	tanjung santan	id
tsy	tasikmalaya	id
tsz	tsetserleg	mn
tta	tan tan	ma
ttb	tortoli	it
ttc	taltal	cl
ttd	troutdale	us
tte	ternate	id
ttg	tartagal	ar
tth	thumrait	om
tti	tetiaroa island	pf
ttj	tottori	jp
ttk	tottenham	gb
ttl	turtle island	fj
ttm	tablon de tamara	co
tto	britton	us
ttq	tortuquero	cr
ttr	tana toraja	id
tts	tsaratanana	mg
ttt	taitung	tw
ttu	tetuan	ma
ttw	tissa tank	lk
tua	tulcan	ec
tub	tubuai	pf
tuc	tucuman	ar
tud	tambacounda	sn
tue	tupile	pa
tuf	tours	fr
tug	tuguegarao	ph
tui	turaif	sa
tuj	tum	et
tuk	turbat	pk
tul	tulsa	us
tum	tumut	au
tun	tunis	tn
tuo	taupo	nz
tup	tupelo	us
tuq	tougan	bf
tur	tucurui	br
tus	tucson	us
tut	tauta	pg
tuu	tabuk	sa
tuv	tucupita	ve
tuw	tubala	pa
tux	tumbler ridge	ca
tuy	tulum	mx
tuz	tucuma	br
tva	morafenobe	mg
tvc	traverse city	us
tvf	thief river falls	us
tvi	thomasville	us
tvl	south lake tahoe	us
tvs	tangshan	cn
tvu	taveuni	fj
tvy	dawe	mm
twa	twin hills	us
twb	toowoomba	au
twd	port townsend	us
twe	taylor	us
twf	twin falls	us
twn	tewantin	au
twp	torwood	au
twt	tawitawi	ph
twu	tawau	my
twy	tawa	pg
txf	teixeira de freitas	br
txg	taichung	tw
txk	texarkana	us
txm	teminabuan	id
txn	tunxi	cn
txr	tanbar	au
txu	tabou	ci
tya	tula	ru
tyb	tibooburra	au
tyd	tynda	ru
tye	tyonek	us
tyf	torsby	se
tyg	thylungra	au
tyl	talara	pe
tym	staniel cay	bs
tyn	taiyuan	cn
tyo	tokyo	jp
typ	tobermorey	au
tyr	tyler	us
tys	knoxville	us
tyt	treinta-y-tres	uy
tyz	taylor	us
tzc	caro	us
tzl	tuzla	ba
tzm	tizimin	mx
tzn	south andros	bs
tzo	ankisatra	mg
tzx	trabzon	tr
uac	san luis rio colorado	mx
uae	mount aue	pg
uah	ua huka	pf
uai	suai	tl
uak	narsarsuaq	gl
ual	luau	ao
uap	ua pou	pf
uaq	san juan	ar
uar	bouarfa	ma
uas	samburu	ke
uax	uaxactun	gt
uba	uberaba	br
ubb	mabuiag island	au
ubi	buin	pg
ubj	ube	jp
ubp	ubon ratchathni	th
ubr	ubrub	id
ubs	columbus	us
ubt	ubatuba	br
ubu	kalumburu	au
uca	utica	us
ucc	yucca flat	us
uce	eunice	us
uck	lutsk	ua
ucn	buchanan	lr
uct	ukhta	ru
ucy	union city	us
uda	undarra	au
ude	uden	nl
udi	uberlandia	br
udj	uzhgorod	ua
udn	udine	it
udo	udomxay	la
udr	udaipur	in
uee	queenstown	au
uel	quelimane	mz
uen	urengoy	ru
ueo	kumejima	jp
uer	puertollano	es
ues	waukesha	us
uet	quetta	pk
ufa	ufa	ru
uga	bulgan	mn
ugc	urgench	uz
ugi	uganik	us
ugn	waukegan	us
ugo	uige	ao
ugs	ugashik	us
ugt	umnugobitour	mn
ugu	zugapa	id
uhe	uherske hradiste	cz
uib	quibdo	co
uih	qui nhon	vn
uii	utila	hn
uik	ust-ilimsk	ru
uil	quillayute	us
uin	quincy	us
uio	quito	ec
uip	quimper	fr
uiq	quine hill	vu
uir	quirindi	au
uit	jaluit island	mh
uiz	utica	us
uje	ujae island	mh
ujn	uljin	kr
uka	ukunda	ke
ukh	mukhaizna	om
uki	ukiah	us
ukk	ust-kamenogorsk	kz
ukn	waukon	us
ukr	mukeiras	ye
uks	sevastopol	ua
ukt	quakertown	us
uku	nuku	pg
ukx	ust-kut	ru
uky	kyoto	jp
ula	san julian	ar
ulb	ulei	vu
uld	ulundi	za
ule	sule	pg
ulg	ulgit	mn
ulh	al ula	sa
uli	ulithi	fm
ulk	lensk	ru
ull	mull	gb
ulm	new ulm	us
uln	ulaanbaatar	mn
ulo	ulaangom	mn
ulp	quilpie	au
ulq	tulua	co
uls	mulatos	co
ulu	gulu	ug
ulx	ulusaba	za
uly	ulyanovsk	ru
ulz	uliastai	mn
uma	punta de maisi	cu
umb	umnak island	us
umc	umba	pg
umd	uummannaq	gl
ume	umea	se
umi	quincemil	pe
umm	summit	us
umr	woomera	au
umt	umiat	us
umu	umuarama	br
umy	sumy	ua
una	una	br
unc	unguia	co
und	kunduz	af
une	qachas nek	ls
ung	kiunga	pg
uni	union island	vc
unk	unalakleet	us
unn	ranong	th
unr	underkhaan	mn
unt	unst shetland island	gb
unu	juneau	us
uol	buol	id
uon	muong sai	la
uos	sewanee	us
uox	oxford	us
upa	punta alegre	cu
upb	havana	cu
upg	ujung pandang	id
upl	upala	cr
upn	uruapan	mx
upp	upolu point	us
upr	upiara	pg
upv	upavon	gb
uqe	queen	us
ura	uralsk	kz
urb	urubupunga	br
urc	urumqi	cn
urd	burg feuerstein	de
ure	kuressaare	ee
urg	uruguaiana	br
uri	uribe	co
urj	uraj	ru
urm	uriman	ve
urn	urgoon	af
uro	rouen	fr
urr	urrao	co
urs	kursk	ru
urt	surat thani	th
uru	uroubi	pg
ury	gurayat	sa
urz	uruzgan	af
ush	ushuaia	ar
usi	mabaruma	gy
usk	usinsk	ru
usl	useless loop	au
usm	koh samui	th
usn	ulsan	kr
uso	usino	pg
usq	usak	tr
uss	sancti spiritus	cu
ust	st augustine	us
usu	busuanga	ph
uta	mutare	zw
utb	muttaburra	au
utc	utrecht	nl
utd	nutwood downs	au
utg	quthing	ls
uth	udon thani	th
uti	valkeala	fi
utk	utirik island	mh
utl	torremolinos	es
utm	tunica	us
utn	upington	za
uto	utopia creek	us
utp	pattaya	th
utr	uttaradit	th
uts	ust-tsilma	ru
utt	umtata	za
utu	ustupo	pa
utw	queenstown	za
uua	bugulma	ru
uud	ulan-ude	ru
uuk	kuparuk	us
uun	baruun-urt	mn
uus	yuzhno-sakhalinsk	ru
uuu	manumu	pg
uva	uvalde	us
uve	ouvea	nc
uvl	kharga	eg
uvo	uvol	pg
uwa	ware	us
uwp	wuppertal	de
uyl	nyala	sd
uyn	yulin	cn
uyu	uyuni	bo
uzc	uzice	rs
uzh	unayzah	sa
uzm	hope bay	ca
uzu	curuzu cuatia	ar
vaa	vaasa	fi
vab	yavarate	co
vac	varrelbusch	de
vaf	valence	fr
vag	varginha	br
vah	vallegrande	bo
vai	vanimo	pg
vak	chevak	us
val	valenca	br
vam	maamigili	mv
van	van	tr
vao	suavanao	sb
vap	valparaiso	cl
var	varna	bg
vas	sivas	tr
vat	vatomandry	mg
vau	vatukoula	fj
vav	vava'u	to
vaw	vardoe	no
vbm	blue mountain	us
vbv	vanuabalavu	fj
vby	visby	se
vca	can tho	vn
vcb	view cove	us
vcd	victoria river downs	au
vce	venice	it
vcf	valcheta	ar
vch	vichadero	uy
vcl	tamky	vn
vcr	carora	ve
vcs	con dao	vn
vct	victoria	us
vcv	victorville	us
vda	ovda	il
vdb	fagernes	no
vdc	vitoria da conquista	br
vde	valverde	es
vdh	dong hoi	vn
vdi	vidalia	us
vdm	viedma	ar
vdp	valle de pascua	ve
vdr	villa dolores	ar
vds	vadso	no
vdy	vidyanagar	in
vdz	valdez	us
vee	venetie	us
veg	maikwak	gy
vel	vernal	us
ver	veracruz	mx
vev	barakoma	sb
vex	tioga	us
vey	vestmannaeyjar	is
vfa	victoria falls	zw
vga	vijayawada	in
vgd	vologda	ru
vgg	vangrieng	la
vgo	vigo	es
vgs	general villegas	ar
vgz	villagarzon	co
vhc	saurimo	ao
vhm	vilhelmina	se
vhn	van horn	us
vhy	vichy	fr
vhz	vahitahi	pf
via	videira	br
vib	villa constitucion	mx
vic	vicenza	it
vie	vienna	at
vif	vieste	it
vig	el vigia	ve
vih	vichy	us
vii	vinh city	vn
vij	spanish town	vg
vik	kavik	us
vil	dakhla	ma
vin	vinnica	ua
viq	viqueque	tl
vis	visalia	us
vit	vitoria	es
viu	viru	sb
viv	vivigani	pg
vix	vitoria	br
vjb	xai xai	mz
vji	abingdon	us
vjq	gurue	mz
vkg	rach gia	vn
vks	vicksburg	us
vkt	vorkuta	ru
vkw	west kavik	us
vla	vandalia	us
vlc	manises	es
vld	valdosta	us
vle	valle	us
vlg	villa gesell	ar
vli	port vila	vu
vlk	volgodonsk	ru
vll	valladolid	es
vlm	villamontes	bo
vln	valencia	ve
vlo	vallejo	us
vlp	vila rica	br
vlr	vallenar	cl
vls	valesdir	vu
vlu	velikiye luki	ru
vlv	valera	ve
vly	anglesey	gb
vme	villa mercedes	ar
vmi	vallemi	py
vmu	baimuru	pg
vna	saravane	la
vnc	venice	us
vnd	vangaindrano	mg
vne	vannes	fr
vng	viengxay	la
vno	vilnius	lt
vnr	vanrook	au
vns	varanasi	in
vnt	ventspils	lv
vnx	vilanculos	mz
vog	volgograd	ru
voh	vohemar	mg
voi	voinjama	lr
vok	camp douglas	us
vol	volos	gr
vot	votuporanga	br
voz	voronezh	ru
vpe	ondjiva	ao
vpg	vipingo	ke
vpn	vopnafjordur	is
vps	valparaiso	us
vpy	chimoio	mz
vpz	valparaiso	us
vqs	vieques	pr
vra	varadero	cu
vrb	vero beach	us
vrc	virac	ph
vre	vredendal	za
vri	varandey	ru
vrk	joroinen	fi
vrl	vila real	pt
vrn	verona	it
vro	matanzas	cu
vrs	versailles	us
vru	vryburg	za
vry	vaeroy	no
vsa	villahermosa	mx
vse	viseu	pt
vsf	springfield	us
vsg	lugansk	ua
vsk	kennewick	us
vso	phuoclong	vn
vta	victoria	hn
vtb	vitebsk	by
vte	vientiane	la
vtf	vatulele	fj
vtg	vung tau	vn
vtl	vittel	fr
vtm	nevatim	il
vtn	valentine	us
vtu	las tunas	cu
vtz	vishakhapatnam	in
vup	valledupar	co
vus	velikij ustyug	ru
vuu	mvuu camp	mw
vvb	mahanoro	mg
vvc	villavicencio	co
vvk	vastervik	se
vvn	malvinas	pe
vvo	vladivostok	ru
vvz	illizi	dz
vxc	lichinga	mz
vxe	sao vicente	cv
vxo	växjö	se
vyd	vryheid	za
vys	peru	us
waa	wales	us
wab	wabag	pg
wac	waca	et
wad	andriamena	mg
wae	wadi ad dawasir	sa
waf	wana	pk
wag	wanganui	nz
wah	wahpeton	us
wai	antsohihy	mg
waj	wawoi falls	pg
wak	ankazoabo	mg
wal	chincoteague	us
wam	ambatondrazaka	mg
wan	waverney	au
wao	wabo	pg
wap	alto palena	cl
waq	antsalova	mg
war	waris	id
was	washington	us
wat	waterford	ie
wau	wauchope	au
wav	wave hill	au
waw	warsaw	pl
wax	zwara	ly
way	waynesburg	us
waz	warwick	au
wba	wahai	id
wbb	stebbins	us
wbc	wapolu	pg
wbd	befandriana	mg
wbe	bealanana	mg
wbg	schleswig-jagel	de
wbk	west branch	us
wbm	wapenamanda	pg
wbn	woburn	us
wbo	beroroha	mg
wbq	beaver	us
wbr	big rapids	us
wbu	boulder	us
wca	castro	cl
wch	chaiten	cl
wcr	chandalar	us
wda	wadi ain	ye
wdb	deep bay	us
wdg	enid	us
wdh	windhoek	na
wdi	wondai	au
wdn	waldron island	us
wdr	winder	us
wea	weatherford	us
wec	wenchang	cn
wed	wedau	pg
wef	weifang	cn
weh	weihai	cn
wei	weipa	au
wel	welkom	za
wep	weam	pg
wet	wagethe	id
wew	wee waa	au
wfd	woodford	gb
wfi	fianarantsoa	mg
wfk	frenchville	us
wga	wagga wagga	au
wgb	bahawalnagar	pk
wgc	warangal	in
wge	walgett	au
wgn	waitangi	nz
wgo	winchester	us
wgp	waingapu	id
wgt	wangaratta	au
wgu	wagau	pg
wgy	wagny	ga
whd	hyder	us
whf	wadi halfa	sd
whk	whakatane	nz
whl	welshpool	au
who	franz josef	nz
whs	whalsay	gb
wht	wharton	us
whu	wuhu	cn
wib	wilbarger	us
wic	wick	gb
wie	wiesbaden	de
wik	surfdale	nz
win	winton	au
wio	wilcannia	au
wir	wairoa	nz
wit	wittenoom	au
wiu	witu	pg
wja	woja	mh
wjf	lancaster	us
wjr	wajir	ke
wju	wonju	kr
wka	wanaka	nz
wkb	warracknabeal	au
wki	hwange	zw
wkj	wakkanai	jp
wkk	aleknagik	us
wkl	waikoloa	us
wkn	wakunai	pg
wkr	walker's cay	bs
wla	wallal	au
wlb	labouchere bay	us
wlc	walcha	au
wld	winfield	us
wlg	wellington	nz
wlh	walaha	vu
wlk	selawik	us
wll	wollogorang	au
wlm	waltham	us
wln	little naukati	us
wlo	waterloo	au
wlr	loring	us
wls	wallis island	wf
wlw	willows	us
wma	mandritsara	mg
wmb	warrnambool	au
wmc	winnemucca	us
wmd	mandabe	mg
wme	mount keith	au
wmh	mountain home	us
wmi	nowy dwor mazowiecki	pl
wmk	meyers chuck	us
wml	malaimbandy	mg
wmn	maroantsetra	mg
wmo	white mountain	us
wmp	mampikony	mg
wmr	mananara	mg
wmv	madirovalo	mg
wmx	wamena	id
wna	napakiak	us
wnc	tuxekan island	us
wnd	windarra	au
wne	wora na ye	ga
wnh	wenshan	cn
wnn	wunnummin lake	ca
wnp	naga	ph
wnr	windorah	au
wns	nawabshah	pk
wnu	wanuma	pg
wnz	wenzhou	cn
woa	wonenara	pg
wod	wood river	us
woe	woensdrecht	nl
wok	wonken	ve
wol	wollongong	au
won	wondoola	au
woo	woodchopper	us
wor	ankorefo	mg
wos	wonsan	kp
wot	wonan	tw
wow	willow	us
wpa	puerto aisen	cl
wpb	port berge	mg
wpc	pincher creek	ca
wpk	wrotham park	au
wpl	powell lake	ca
wpm	wipim	pg
wpo	paonia	us
wpr	porvenir	cl
wpu	puerto williams	cl
wra	warder	et
wre	whangarei	nz
wrg	wrangell	us
wrh	wrench creek	us
wri	wrightstown	us
wrl	worland	us
wro	wroclaw	pl
wrw	warrawagine	au
wry	westray	gb
wrz	wirawila	lk
wsa	wasua	pg
wsb	steamboat bay	us
wsd	white sands	us
wsf	sarichef	us
wsg	washington	us
wsh	shirley	us
wsj	san juan	us
wsm	wiseman	us
wsn	south naknek	us
wso	washabo	sr
wsp	waspam	ni
wsr	wasior	id
wst	westerly	us
wsu	wasu	pg
wsx	westsound	us
wsy	airlie beach	au
wsz	westport	nz
wta	tambohorano	mg
wtd	west end	bs
wte	wotje island	mh
wtk	noatak	us
wtl	tuntutuliak	us
wtn	waddington	gb
wto	wotho island	mh
wtp	woitape	pg
wtr	white river	us
wts	tsiroanomandidy	mg
wtt	wantoat	pg
wtz	whitianga	nz
wua	wu hai	cn
wud	wudinna	au
wug	wau	pg
wuh	wuhan	cn
wum	wasum	pg
wun	wiluna	au
wus	wuyishan	cn
wuu	wau	ss
wuv	wuvulu island	pg
wux	wuxi	cn
wuz	wuzhou	cn
wvb	walvis bay	na
wvi	watsonville	us
wvk	manakara	mg
wvl	waterville	us
wvn	wilhelmshaven	de
wwa	wasilla	us
wwd	wildwood	us
wwi	woodie woodie	au
wwk	wewak	pg
wwp	whale pass	us
wwr	woodward	us
wws	wildwood	us
wwt	newtok	us
wwy	west wyalong	au
wxj	wanning	cn
wxn	wanxian	cn
wya	whyalla	au
wyb	yes bay	us
wye	yengema	sl
wyn	wyndham	au
wys	west yellowstone	us
xah	silkeborg	dk
xaj	hirtshals	dk
xal	alamos	mx
xap	chapeco	br
xaq	bronderslev	dk
xar	aribinda	bf
xau	saul	gf
xaw	capreol	ca
xay	xayabury	la
xaz	campbellton	ca
xbb	blubber bay	ca
xbe	bearskin lake	ca
xbg	bogande	bf
xbj	birjand	ir
xbl	buno bedelle	et
xbn	biniguni	pg
xbo	boulsa	bf
xbr	brockville	ca
xbw	killineq	ca
xcc	le creusot/montceau	fr
xch	christmas island	cx
xci	chambord	ca
xcl	cluff lake	ca
xcm	chatham	ca
xcn	puerto princesa city	ph
xco	colac	au
xde	diebougou	bf
xdj	djibo	bf
xdl	chandler	ca
xdm	drummondville	ca
xdo	grande-riviere	ca
xdu	hervey	ca
xed	disneyland paris	fr
xee	lac edouard	ca
xeh	ladysmith	ca
xej	langford	ca
xek	melville	ca
xel	new carlisle	ca
xem	new richmond	ca
xen	xingcheng	cn
xeo	oqatsut	gl
xeq	tasiuasaq	gl
xes	lake geneva	us
xew	flemingsberg	se
xey	miramichi	ca
xfc	fredericton junction	ca
xfd	stratford	ca
xfe	parent	ca
xfg	perce	ca
xfh	strangnas	se
xfi	port-daniel	ca
xfk	senneterre	ca
xfl	shawinigan	ca
xfm	shawnigan	ca
xfn	xiangfan	cn
xfo	taschereau	ca
xfq	weymont	ca
xfs	alexandria	ca
xfu	tierp	se
xfv	brantford	ca
xga	gaoua	bf
xgc	lund	se
xgd	arendal	no
xgg	gorom-gorom	bf
xgh	flam	no
xgi	andalsnes	no
xgj	cobourg	ca
xgk	coteau	ca
xgl	granville lake	ca
xgm	grantham	gb
xgn	xangongo	ao
xgp	dombas	no
xgq	saariselka	fi
xgr	kangiqsualujjuaq	ca
xgs	gjerstad	no
xgu	asker	no
xgw	gananoque	ca
xgx	levi	fi
xgy	grimsby	ca
xgz	bregenz	at
xha	yllasjarvi	fi
xhc	akaslompolo	fi
xhd	ruka	fi
xhf	honefoss	no
xhi	herzogenaurach	de
xhl	nelaug	no
xhm	georgetown	ca
xho	dongguan	cn
xhq	artvin	tr
xhs	chemainus	ca
xht	arna	no
xhu	huntingdon	gb
xhv	brasov	ro
xia	guelph	ca
xib	ingersoll	ca
xic	xichang	cn
xid	maxville	ca
xie	xienglom	la
xif	napanee	ca
xig	xinguara	br
xii	prescott	ca
xij	ahmed al jaber	kw
xil	xilinhot	cn
xim	saint hyacinthe	ca
xin	xingning	cn
xio	st marys	ca
xip	woodstock	ca
xiq	ilimanaq	gl
xja	alvdal	no
xjd	al udeid	qa
xjl	joliette	ca
xjo	soria	es
xjq	jonquiere	ca
xjr	lorca	es
xjs	kitzbuehl	at
xka	kantchari	bf
xkb	kongsberg	no
xkc	sandnes	no
xkd	halden	no
xke	rena	no
xkf	fredrikstad	no
xkg	grong	no
xkh	xieng khouang	la
xki	lillestrom	no
xkj	steinkjer	no
xkk	larvik	no
xkm	moss	no
xkn	finse	no
xko	kemano	ca
xkp	porsgrunn	no
xkq	sarpsborg	no
xks	kasabonika	ca
xkv	sackville	ca
xkw	tonsberg	no
xky	kaya	bf
xkz	vinstra	no
xlb	lac brochet	ca
xlf	leaf bay	ca
xlo	long xuyen	vn
xlp	matapedia	ca
xls	st louis	sn
xlu	leo	bf
xlv	niagara falls	ca
xlw	lemwerder	de
xly	aldershot	ca
xlz	truro	ca
xma	maramag	ph
xmc	mallacoota	au
xmd	madison	us
xmg	mahendranagar	np
xmh	manihi	pf
xmi	masasi	tz
xml	minlaton	au
xmn	xiamen	cn
xmp	macmillan pass	ca
xms	macas	ec
xmy	yam island	au
xmz	macclesfield	gb
xnd	drammen	no
xne	newport	gb
xng	quang ngai	vn
xnn	xining	cn
xno	northallerton	gb
xnr	aabenraa	dk
xnt	xingtai	cn
xnu	nouna	bf
xnv	nuneaton	gb
xoa	aalbaek	dk
xob	bryne	no
xod	oppdal	no
xoi	ischgl	at
xok	oakville	ca
xol	myrdal	no
xon	carleton	ca
xoo	soelden	at
xoq	sira	no
xor	otta	no
xou	segovia	es
xow	seefeld	at
xpa	pama	bf
xpb	parksville	ca
xpf	penrith	gb
xph	port hope	ca
xpk	pukatawagan	ca
xpl	comayagua	hn
xpn	brampton	ca
xpp	poplar river	ca
xpq	port klang	my
xpr	pine ridge	us
xpt	preston	gb
xpu	west kuparuk	us
xpw	didcot	gb
xpx	pointe-aux-trembles	ca
xpy	pyha	fi
xqb	basingstoke	gb
xqd	bedford	gb
xqg	berwick-upon-tweed	gb
xqh	derby	gb
xqi	loughborough	gb
xql	lancaster	gb
xqm	market harborough	gb
xqp	pavones	cr
xqs	sotkamo	fi
xqt	lichfield	gb
xqu	qualicum	ca
xqw	motherwell	gb
xra	graasten	dk
xrc	runcorn	gb
xrd	egersund	no
xre	reading	gb
xrg	rugeley	gb
xrh	richmond	au
xrp	riviere-a-pierre	ca
xrr	ross river	ca
xru	rugby	gb
xry	jerez de la frontera	es
xsc	south caicos	tc
xse	sebba	bf
xsi	south indian lake	ca
xsm	st marys	us
xso	siocon	ph
xsr	salisbury	gb
xtg	thargomindah	au
xtj	toledo	es
xtk	thirsk	gb
xtl	tadoule lake	ca
xto	taroom	au
xtr	tara	au
xty	strathroy	ca
xub	berkak	no
xuc	elverum	no
xue	heimdal	no
xuf	cartagena	es
xug	holmestrand	no
xuh	levanger	no
xui	lysaker	no
xuj	moelv	no
xul	nesbyen	no
xum	neslandsvatn	no
xuo	nordagutu	no
xuq	ringebu	no
xur	skoppum	no
xus	snartemo	no
xuu	stjordal	no
xuv	storekvina	no
xuw	storen	no
xux	ustaoset	no
xuz	xuzhou	cn
xva	stockport	gb
xvb	stafford	gb
xvc	crewe	gb
xvg	darlington	gb
xvh	peterborough	gb
xvj	stevenage	gb
xvk	voss	no
xvl	vinh long	vn
xvm	vuokatti	fi
xvs	valenciennes	fr
xvv	belleville	ca
xvw	wolverhampton	gb
xvx	vejle	dk
xwa	watford	ca
xwb	stirling	gb
xwd	wakefield	gb
xwe	wellingborough	gb
xwh	stoke-on-trent	gb
xwi	wigan	gb
xwm	hallsberg	se
xwn	warrington	gb
xwo	woking	gb
xwp	hassleholm	se
xwq	enkoping	se
xws	swindon	gb
xwv	varberg	se
xwx	nassjo	se
xwy	wyoming	ca
xwz	nykoping	se
xxa	alvesta	se
xxc	bo	no
xxd	degerfors	se
xxe	vennesla	no
xxg	verdal	no
xxi	koping	se
xxk	katrineholm	se
xxl	lillehammer	no
xxm	mjolby	se
xxn	kil	se
xxo	leksand	se
xxr	al	no
xxt	arboga	se
xxu	hedemora	se
xxv	kumla	se
xya	yandina	sb
xyc	herrljunga	se
xye	ye	mm
xyf	falkoping	se
xyi	flen	se
xym	falkenberg	se
xyn	kristinehamn	se
xyo	karlshamn	se
xyp	avesta krylbo	se
xyr	yellow river	pg
xyu	solvesborg	se
xyx	sala	se
xyy	arvika	se
xza	zabre	bf
xzb	casselman	ca
xzc	glencoe	ca
xzd	kongsvinger	no
xzk	amherst	ca
yaa	anahim lake	ca
yab	arctic bay	ca
yac	cat lake	ca
yad	moose lake	ca
yae	alta lake	ca
yaf	asbestos hill	ca
yag	fort frances	ca
yah	lagrande 4	ca
yai	chillan	cl
yaj	lyall harbour	ca
yak	yakutat	us
yal	alert bay	ca
yam	sault sainte marie	ca
yan	yangambi	cd
yao	yaounde	cm
yap	yap	fm
yaq	maple bay	ca
yar	lagrande 3	ca
yas	yasawa island	fj
yat	attawapiskat	ca
yau	kattiniq	ca
yav	miners bay	ca
yax	angling lake	ca
yay	st anthony	ca
yaz	tofino	ca
yba	banff	ca
ybb	kugaaruk	ca
ybc	baie comeau	ca
ybd	new westminster	ca
ybe	uranium city	ca
ybf	bamfield	ca
ybg	bagotville	ca
ybh	bull harbour	ca
ybi	black tickle	ca
ybj	baie johan beetz	ca
ybk	baker lake	ca
ybl	campbell river	ca
ybm	bronson creek	ca
ybn	borden	ca
ybo	bobquinn lake	ca
ybp	yibin	cn
ybq	telegraph harbour	ca
ybr	brandon	ca
ybs	opapamiska lake	ca
ybt	brochet	ca
ybv	berens river	ca
ybw	bedwell harbor	ca
ybx	blanc sablon	ca
yby	bonnyville	ca
yca	courtenay	ca
ycb	cambridge bay	ca
ycc	cornwall	ca
ycd	nanaimo	ca
yce	centralia	ca
ycf	cortes bay	ca
ycg	castlegar	ca
ych	miramichi	ca
yci	caribou island	ca
ycj	cape st james	ca
yck	colville lake	ca
ycl	charlo	ca
ycm	st catharines	ca
ycn	cochrane	ca
yco	kugluktuk	ca
ycp	co-op point	ca
ycq	chetwynd	ca
ycr	cross lake	ca
ycs	chesterfield inlet	ca
yct	coronation	ca
ycu	yun cheng	cn
ycv	cartierville	ca
ycw	chilliwack	ca
ycx	gagetown	ca
ycy	clyde river	ca
ycz	fairmont hot springs	ca
yda	dawson city	ca
ydb	burwash landings	ca
ydc	drayton valley	ca
yde	paradise river	ca
ydf	deer lake	ca
ydg	digby	ca
ydh	daniels harbour	ca
ydi	davis inlet	ca
ydj	hatchet lake	ca
ydk	main duck island	ca
ydl	dease lake	ca
ydn	dauphin	ca
ydo	dolbeau	ca
ydp	nain	ca
ydq	dawson creek	ca
ydr	broadview	ca
yds	desolation sound	ca
ydu	kasba lake	ca
ydv	bloodvein	ca
ydw	obre lake	ca
ydx	doc creek	ca
yea	edmonton	ca
yeb	bar river	ca
yec	yecheon	kr
yei	bursa	tr
yek	arviat	ca
yel	elliot lake	ca
yem	manitowaning	ca
yen	estevan	ca
yeo	yeovilton	gb
yep	estevan point	ca
yeq	yenkis	pg
yer	fort severn	ca
yes	yasouj	ir
yet	edson	ca
yeu	eureka	ca
yev	inuvik	ca
yey	amos	ca
yfa	fort albany	ca
yfb	iqaluit	ca
yfc	fredericton	ca
yfe	forestville	ca
yfg	fontanges	ca
yfh	fort hope	ca
yfj	snare lake	ca
yfl	fort reliance	ca
yfo	flin flon	ca
yfr	fort resolution	ca
yfs	fort simpson	ca
yft	taipa	mo
yfx	fox harbour (st lewis)	ca
yga	gagnon	ca
ygb	gillies bay	ca
ygc	grande cache	ca
yge	gorge harbor	ca
ygg	ganges harbor	ca
ygh	fort good hope	ca
ygj	yonago	jp
ygk	kingston	ca
ygl	la grande	ca
ygm	gimli	ca
ygn	greenway sound	ca
ygo	gods narrows	ca
ygp	gaspe	ca
ygq	geraldton	ca
ygr	iles de la madeleine	ca
ygs	germansen	ca
ygt	igloolik	ca
ygv	havre st pierre	ca
ygw	kuujjuarapik	ca
ygx	gillam	ca
ygy	deception	ca
ygz	grise fiord	ca
yha	port hope simpson	ca
yhb	hudson bay	ca
yhc	hakai pass	ca
yhd	dryden	ca
yhe	hope	ca
yhf	hearst	ca
yhg	charlottetown	ca
yhi	holman	ca
yhk	gjoa haven	ca
yhn	hornepayne	ca
yho	hopedale	ca
yhp	poplar hill	ca
yhr	chevery	ca
yhs	sechelt	ca
yht	haines junction	ca
yhy	hay river	ca
yhz	halifax	ca
yib	atikokan	ca
yie	aershan	cn
yif	pakuashipi	ca
yig	big bay marina	ca
yih	yichang	cn
yik	ivujivik	ca
yin	yining	cn
yio	pond inlet	ca
yiv	island lake	ca
yiw	yiwu	cn
yja	jasper	ca
yjf	fort liard	ca
yjn	st jean	ca
yjo	johnny mountain	ca
yjp	jasper-hinton	ca
yjs	samjiyon	kp
yjt	stephenville	ca
yka	kamloops	ca
ykc	collins bay	ca
ykd	kincardine	ca
yke	knee lake	ca
ykf	kitchener-waterloo	ca
ykg	kangirsuk	ca
yki	kennosao lake	ca
ykj	key lake	ca
ykk	kitkatla	ca
ykl	schefferville	ca
ykm	yakima	us
ykn	yankton	us
ykq	waskaganish	ca
yks	yakutsk	ru
ykt	klemtu	ca
yku	chisasibi	ca
ykx	kirkland lake	ca
yky	kindersley	ca
yla	langara	ca
ylb	lac biche	ca
ylc	kimmirut	ca
yld	chapleau	ca
yle	wha ti	ca
ylf	laforges	ca
ylg	yalgoo	au
ylh	lansdowne house	ca
yli	ylivieska	fi
ylj	meadow lake	ca
ylk	oro station	ca
yll	lloydminster	ca
ylm	clinton creek	ca
yln	yilan	cn
ylo	shilo	ca
ylp	mingan	ca
ylq	la tuque	ca
ylr	leaf rapids	ca
yls	lebel-sur-quevillon	ca
ylt	alert	ca
ylw	kelowna	ca
ylx	long point	ca
yly	langley	ca
yma	mayo	ca
ymb	merritt	ca
ymc	maricourt airstrip	ca
ymd	mould bay	ca
yme	matane	ca
ymf	montagne harbor	ca
ymg	manitouwadge	ca
ymh	mary's harbour	ca
ymi	minaki	ca
ymj	moose jaw	ca
ymk	mys-kamenny	ru
yml	murray bay	ca
ymm	fort mcmurray	ca
ymn	makkovik	ca
ymo	moosonee	ca
ymp	port mcneil	ca
ymq	montreal	ca
ymr	merry island	ca
yms	yurimaguas	pe
ymt	chibougamau	ca
ymu	mansons landing	ca
ymv	mary river	ca
ymw	maniwaki	ca
yna	natashquan	ca
ynb	yanbu	sa
ync	wemindji	ca
yne	norway house	ca
ynf	corner brook	ca
yng	youngstown	us
ynh	hudson's  hope	ca
yni	nitchequon	ca
ynj	yanji	cn
ynk	nootka sound	ca
ynl	points north landing	ca
ynm	matagami	ca
ynn	yandicoogina	au
yno	north spirit lake	ca
ynp	natuashish	ca
ynr	arnes	ca
yns	nemiscau	ca
ynt	yantai	cn
ynx	snap lake	ca
yny	yangyang	kr
ynz	yancheng	cn
yoa	ekati	ca
yoc	old crow	ca
yod	cold lake	ca
yoe	falher	ca
yog	ogoki	ca
yoh	oxford house	ca
yoi	opinaca	ca
yoj	high level	ca
yok	yokohama	jp
yol	yola	ng
yop	rainbow lake	ca
yos	owen sound	ca
yot	yotvata	il
yow	ottawa	ca
yoy	valcartier	ca
ypa	prince albert	ca
ypb	port alberni	ca
ypc	paulatuk	ca
ypd	parry sound	ca
ype	peace river	ca
ypf	esquimalt	ca
ypg	portage la prairie	ca
yph	inukjuak	ca
ypi	port simpson	ca
ypj	aupaluk	ca
ypl	pickle lake	ca
ypm	pikangikum	ca
ypn	port menier	ca
ypo	peawanuck	ca
ypp	pine point	ca
ypq	peterborough	ca
ypr	prince rupert	ca
yps	port hawkesbury	ca
ypt	pender harbor	ca
ypw	powell river	ca
ypx	povungnituk	ca
ypy	fort chipewyan	ca
ypz	burns lake	ca
yqa	muskoka	ca
yqb	québec city	ca
yqc	quaqtaq	ca
yqd	the pas	ca
yqe	kimberley	ca
yqf	red deer	ca
yqg	windsor	ca
yqh	watson lake	ca
yqi	yarmouth	ca
yqj	quadra island	ca
yqk	kenora	ca
yql	lethbridge	ca
yqm	moncton	ca
yqn	nakina	ca
yqq	comox	ca
yqr	regina	ca
yqs	st thomas	ca
yqt	thunder bay	ca
yqu	grande prairie	ca
yqv	yorkton	ca
yqw	north battleford	ca
yqx	gander	ca
yqy	sydney	ca
yqz	quesnel	ca
yra	rae lakes	ca
yrb	resolute	ca
yrc	refuge cove	ca
yrd	dean river	ca
yre	resolution island	ca
yrf	cartwright	ca
yrg	rigolet	ca
yri	riviere du loup	ca
yrj	roberval	ca
yrl	red lake	ca
yrm	rocky mountain house	ca
yrn	owekeno village	ca
yrq	trois-rivieres	ca
yrr	stuart island	ca
yrs	red sucker lake	ca
yrt	rankin inlet	ca
yrv	revelstoke	ca
ysa	sable island	ca
ysb	sudbury	ca
ysc	sherbrooke	ca
ysd	suffield	ca
yse	squamish	ca
ysf	stony rapids	ca
ysg	lutselke	ca
ysh	smith falls	ca
ysi	sans souci	ca
ysj	saint john	ca
ysk	sanikiluaq	ca
ysl	st leonard	ca
ysm	fort smith	ca
ysn	salmon arm	ca
yso	postville	ca
ysp	marathon	ca
ysq	spring island	ca
ysr	nanisivik	ca
yss	slate island	ca
yst	ste therese point	ca
ysu	summerside	ca
ysv	saglek	ca
ysw	salluit	ca
ysx	shearwater	ca
ysy	sachs harbour	ca
ysz	squirrel cove	ca
yta	pembroke	ca
ytb	hartley bay	ca
ytc	sturdee	ca
ytd	thicket portage	ca
yte	cape dorset	ca
ytf	alma	ca
ytg	sullivan bay	ca
yth	thompson	ca
yti	triple island	ca
ytj	terrace bay	ca
ytk	tulugak	ca
ytl	big trout	ca
ytm	mont tremblant	ca
ytn	riviere au tonnerre	ca
yto	toronto	ca
ytq	tasiujuaq	ca
ytr	trenton	ca
yts	timmins	ca
ytt	tisdale	ca
ytu	tasu	ca
ytx	telegraph creek	ca
yty	yangzhou	cn
yua	yuanmou	cn
yub	tuktoyaktuk	ca
yud	umiujaq	ca
yue	yuendumu	au
yum	yuma	us
yus	yushu	cn
yut	repulse bay	ca
yux	hall beach	ca
yuy	rouyn-noranda	ca
yva	moroni	km
yvb	bonaventure	ca
yvc	la ronge	ca
yvd	yeva	pg
yve	vernon	ca
yvg	vermilion	ca
yvh	hjerkinn	no
yvk	koppang	no
yvm	qikiqtarjuaq	ca
yvn	cape dyer	ca
yvo	val-d'or	ca
yvp	kuujjuaq	ca
yvq	norman wells	ca
yvr	vancouver	ca
yvs	ski	no
yvt	buffalo narrows	ca
yvv	wiarton	ca
yvz	deer lake	ca
ywa	petawawa	ca
ywb	kangiqsujuaq	ca
ywg	winnipeg	ca
ywj	deline	ca
ywk	wabush	ca
ywl	williams lake	ca
ywm	williams harbour	ca
ywn	winisk	ca
ywo	lupin	ca
ywp	webequie	ca
ywq	chute-des-passes	ca
ywr	white river	ca
yws	whistler	ca
ywy	wrigley	ca
yxc	cranbrook	ca
yxe	saskatoon	ca
yxf	snake river	ca
yxh	medicine hat	ca
yxi	killaloe	ca
yxj	fort st john	ca
yxk	rimouski	ca
yxl	sioux lookout	ca
yxn	whale cove	ca
yxp	pangnirtung	ca
yxq	beaver creek	ca
yxr	earlton	ca
yxs	prince george	ca
yxt	terrace	ca
yxu	london	ca
yxx	abbotsford	ca
yxy	whitehorse	ca
yxz	wawa	ca
yya	big bay yacht club	ca
yyb	north bay	ca
yyc	calgary	ca
yyd	smithers	ca
yye	fort nelson	ca
yyf	penticton	ca
yyg	charlottetown	ca
yyh	taloyoak	ca
yyi	rivers	ca
yyj	victoria	ca
yyl	lynn lake	ca
yym	cowley	ca
yyn	swift current	ca
yyq	churchill	ca
yyr	happy valley-goose bay	ca
yyt	st. john's	ca
yyu	kapuskasing	ca
yyw	armstrong	ca
yyy	mont joli	ca
yza	ashcroft	ca
yzc	beatton river	ca
yze	gore bay	ca
yzf	yellowknife	ca
yzh	slave lake	ca
yzm	buchans	ca
yzp	sandspit	ca
yzr	sarnia	ca
yzs	coral harbour	ca
yzt	port hardy	ca
yzu	whitecourt	ca
yzv	sept-iles	ca
yzw	teslin	ca
yzx	greenwood	ca
yzy	zhangye	cn
yzz	trail	ca
zaa	alice arm	ca
zac	york landing	ca
zad	zadar	hr
zaf	arles	fr
zag	zagreb	hr
zah	zahedan	ir
zaj	zaranj	af
zak	chiusa/klausen	it
zal	valdivia	cl
zam	zamboanga	ph
zao	cahors	fr
zap	appenzell	ch
zar	zaria	ng
zas	shunde	cn
zat	zhaotong	cn
zau	aue	de
zaw	nykobing mors	dk
zax	pan yu	cn
zaz	zaragoza	es
zbd	jiang men	cn
zbe	zabreh	cz
zbf	bathurst	ca
zbh	severac-le-chateau	fr
zbj	fredericia	dk
zbk	zabljak	me
zbl	biloela	au
zbm	bromont	ca
zbo	bowen	au
zbr	chah-bahar	ir
zbt	kolding	dk
zby	sayaboury	la
zbz	xin hui	cn
zca	tai shan	cn
zcb	aschaffenburg	de
zcl	zacatecas	mx
zco	temuco	cl
zda	aarau	ch
zdb	adelboden	ch
zdc	aigle	ch
zdd	arbon	ch
zde	arosa	ch
zdg	baden	ch
zdi	bellinzona	ch
zdk	biel/bienne	ch
zdl	brig	ch
zdo	buchs sg	ch
zdp	burgdorf	ch
zdq	champery	ch
zdr	chateau-d'oex	ch
zds	chiasso	ch
zdt	chur	ch
zdv	davos	ch
zdw	delemont	ch
zdx	dietikon	ch
zdz	einsiedeln	ch
zec	secunda	za
zee	fulda	de
zef	nanhai	cn
zeg	senggo	id
zei	garmisch-partenkirchen	de
zej	gelsenkirchen	de
zel	bella bella	ca
zem	east main	ca
zen	zenag	pg
zeq	dewsbury	gb
zer	zero	in
zeu	goettingen	de
zey	hagen	de
zfa	faro	ca
zfb	old fort bay	ca
zfd	fond du lac	ca
zfi	chesterfield	gb
zfk	guderup	dk
zfl	south trout lake	ca
zfm	fort mcpherson	ca
zfn	tulita	ca
zfr	frankfurt (oder)	de
zfu	aruja	br
zfw	fairview	ca
zga	gera	de
zge	goerlitz	de
zgf	grand forks	ca
zgi	gods river	ca
zgl	south galway	au
zgm	ngoma	zm
zgn	zhongshan	cn
zgo	gotha	de
zgr	little grand rapids	ca
zgs	gethsemani	ca
zgu	gaua	vu
zgw	greifswald	de
zgx	viborg	dk
zgy	kuching	my
zha	zhanjiang	cn
zhb	engelberg	ch
zhd	fluelen	ch
zhe	frauenfeld	ch
zhf	fribourg	ch
zhg	glarus	ch
zhh	gossau sg	ch
zhi	grenchen	ch
zhj	grindelwald	ch
zhk	gstaad	ch
zhl	heerbrugg	ch
zhm	shamshernagar	bd
zhn	herzogenbuchsee	ch
zho	houston	ca
zhp	high prairie	ca
zhr	kandersteg	ch
zhs	klosters	ch
zhu	kreuzlingen	ch
zhv	la chaux-de-fonds	ch
zhw	langenthal	ch
zhy	zhongwei	cn
zib	nyborg	dk
zic	victoria	cl
zie	vulcano	it
zig	ziguinchor	sn
zih	ixtapa	mx
zij	nykobing sjaelland	dk
zil	horsens	dk
zin	interlaken	ch
zio	solingen	de
zip	lipari	it
ziq	salina island	it
zir	randers	dk
zit	zittau	de
ziy	lianhuashan	cn
ziz	zamzama	pk
zja	le locle	ch
zjb	kuantan	my
zjc	lenzburg	ch
zjd	lenzerheide/lai	ch
zje	panarea	it
zjg	jenpeg	ca
zji	locarno	ch
zjj	procida	it
zjl	lyss	ch
zjm	martigny	ch
zjn	swan river	ca
zjp	montreux	ch
zjq	morges	ch
zjr	penang	my
zjs	jena	de
zjt	tanjung pelepas	my
zju	olten	ch
zjv	pontresina	ch
zjw	rapperswil	ch
zjx	stromboli	it
zjy	ponza	it
zjz	rorschach	ch
zka	sargans	ch
zkb	kasaba bay	zm
zkc	sarnen	ch
zke	kaschechewan	ca
zkf	st margrethen	ch
zkg	kegaska	ca
zki	saas-fee	ch
zkj	schaffhausen	ch
zkk	schwyz	ch
zkl	steenkool	id
zkm	sette cama	ga
zko	sierre/siders	ch
zks	solothurn	ch
zku	sursee	ch
zkv	thalwil	ch
zkw	wetzikon	ch
zkx	uzwil	ch
zky	verbier	ch
zkz	vevey	ch
zla	villars-sur-ollon	ch
zlb	visp	ch
zlc	waedenswil	ch
zld	weinfelden	ch
zle	wengen	ch
zlf	wettingen	ch
zlg	el gouera	hu
zlh	wil	ch
zli	winterthur	ch
zlj	yverdon-les-bains	ch
zll	zofingen	ch
zlm	zug	ch
zlo	manzanillo	mx
zlt	la tabatiere	ca
zlu	ludwigslust	de
zlv	luosto	fi
zlw	pasir gudang	my
zma	mansfield	gb
zmc	miedzyzdroje	pl
zmd	sena madureira	br
zmh	108 mile ranch	ca
zmk	bintulu	my
zmm	zamora	mx
zmo	modena	it
zmq	raufoss	no
zmr	merano/meran	it
zmt	masset	ca
zmw	brande	dk
zmx	tynset	no
zmy	huangpu	cn
zmz	bjerka	no
znb	hamm	de
znc	nyac	us
znd	zinder	ne
zne	newman	au
zng	negginan	ca
znu	namu	ca
znv	koblenz	de
znw	limburg	de
znz	zanzibar	tz
zof	ocean falls	ca
zog	lueneburg	de
zom	minden	de
zoo	muelheim an der ruhr	de
zos	osorno	cl
zoy	oberhausen	de
zpa	offenburg	de
zpb	sachigo lake	ca
zpc	pucon	cl
zpd	oldenburg	de
zpf	passau	de
zph	zephyrhills	us
zpl	recklinghausen	de
zpm	regensburg	de
zpo	pine house	ca
zpy	siegburg	de
zqf	trier	de
zqn	queenstown	nz
zqs	queen charlotte island	ca
zqv	worms	de
zqy	giessen	de
zqz	zhangjiakou	cn
zrc	san pedro de alcantara	es
zrh	zurich	ch
zri	serui	id
zrj	round lake	ca
zrm	sarmi	id
zrn	nyon	ch
zro	reggio nell'emilia	it
zrr	fiumicino	it
zrs	zurs	at
zrw	rastatt	de
zry	herning	dk
zsa	san salvador	bs
zsc	schoena	de
zsd	schwanheide	de
zse	st pierre dela reunion	re
zsg	sonneberg	de
zsh	santa fe	us
zsi	sassnitz	de
zsj	sandy lake	ca
zsk	pasewalk	de
zsm	santa clara	us
zsn	stendal	de
zso	suhl	de
zsp	st paul	ca
zsq	salzwedel	de
zss	sassandra	ci
zst	stewart	ca
zsu	dessau	de
zsy	scottsdale	us
zta	tureira	pf
ztb	tete-a-la baleine	ca
ztf	stamford	us
zth	zakinthos	gr
zti	humen	cn
ztk	thun	ch
ztm	shamattawa	ca
ztr	zhitomir	ua
zts	tahsis	ca
ztu	zaqatala	az
ztv	sturtevant	us
ztw	tsuen wan	hk
ztz	chemnitz	de
zuc	ignace	ca
zud	ancud	cl
zuh	zhuhai	cn
zuk	lake cook road	us
zul	zilfi	sa
zum	churchill falls	ca
zva	miandrivazo	mg
zvb	brumunddal	no
zvc	villarrica	cl
zvd	drangedal	no
zvg	springvale	au
zvk	savannakhet	la
zwa	andapa	mg
zwd	warnemuende	de
zwj	haugastol	no
zwl	wollaston lake	ca
zwm	wismar	de
zwn	wittenberge	de
zwr	kota kinabalu	my
zwt	lutherstadt wittenberg	de
zwv	glenview	us
zxm	rognan	no
zxo	fauske	no
zxu	rygge	no
zxx	rade	no
zyg	gjovik	no
zyi	zunyi	cn
zyk	shekou	cn
zyl	sylhet	bd
zym	arnhem	nl
zyo	roosendaal	nl
zys	sandefjord	no
zyv	vegarshei	no
zyw	sandvika	no
zyy	marnardal	no
zzo	zonalnoye	ru
zzu	mzuzu	mw
zzv	zanesville	us
